iter,op,fitness_score,pref_penalty,capacity_viol,elig_viol,under_cap,total_violations,gini
1,swap,30515.0,335,48,52,9,100,0.24985772673185366
2,swap,30515.0,335,48,52,9,100,0.24985772673185366
3,reassign,30512.0,332,48,52,9,100,0.24992300585155522
4,reassign,29916.0,336,46,52,9,98,0.25542068679323604
5,reassign,29916.0,336,46,52,9,98,0.25542068679323604
6,reassign,29916.0,336,46,52,9,98,0.25542068679323604
7,mut_micro,29916.0,336,46,52,9,98,0.25542068679323604
8,mut_micro,29319.0,339,44,52,9,96,0.2552941176470589
9,mut_micro,29316.0,336,43,53,9,96,0.25542068679323604
10,swap,29316.0,336,43,53,9,96,0.25542068679323604
11,mut_micro,29018.0,338,41,54,9,95,0.25813516896120153
12,mut_micro,28420.0,340,40,53,9,93,0.2589912970535807
13,mut_micro,28420.0,340,40,53,9,93,0.2589912970535807
14,mut_micro,28420.0,340,40,53,9,93,0.2589912970535807
15,mut_micro,28420.0,340,40,53,9,93,0.2589912970535807
16,mut_micro,28420.0,340,40,53,9,93,0.2589912970535807
17,mut_micro,28420.0,340,40,53,9,93,0.2589912970535807
18,mut_micro,28420.0,340,40,53,9,93,0.2589912970535807
19,mut_micro,27515.0,335,39,51,9,90,0.2545656785141497
20,swap,27513.0,333,39,51,9,90,0.25539087025886487
21,mut_micro,27512.0,332,39,51,9,90,0.2535160661123087
22,mut_micro,27209.0,329,39,50,9,89,0.2506493506493506
23,mut_micro,26906.0,326,38,50,9,88,0.24767535880331518
24,mut_micro,26605.0,325,36,51,9,87,0.24504763344926647
25,mut_micro,26605.0,325,36,51,9,87,0.24504763344926647
26,mut_micro,25709.0,329,35,49,9,84,0.24708428826075887
27,mut_micro,25385.0,325,34,49,8,83,0.24504763344926647
28,mut_micro,25063.0,323,32,50,7,82,0.24394463667820077
29,mut_micro,24159.0,319,31,48,7,79,0.23819806403574081
30,mut_micro,24159.0,319,31,48,7,79,0.23819806403574081
31,mut_micro,23864.0,324,31,47,7,78,0.24303670186023146
32,mut_micro,23864.0,324,31,47,7,78,0.24303670186023146
33,mut_micro,23565.0,325,31,46,7,77,0.24323302585815815
34,mut_micro,23565.0,325,31,46,7,77,0.24323302585815815
35,mut_micro,23250.0,330,31,45,6,76,0.2479064542483661
36,mut_micro,22949.0,329,30,45,6,75,0.24774637127578297
37,mut_micro,22949.0,329,30,45,6,75,0.24774637127578297
38,mut_micro,22949.0,329,30,45,6,75,0.24774637127578297
39,mut_micro,22947.0,327,31,44,6,75,0.24489537417033974
40,mut_micro,22609.0,329,30,44,4,74,0.2494270435446906
41,mut_micro,22609.0,329,30,44,4,74,0.2494270435446906
42,mut_micro,22609.0,329,30,44,4,74,0.2494270435446906
43,mut_micro,22609.0,329,30,44,4,74,0.2494270435446906
44,mut_micro,22012.0,332,29,43,4,72,0.2495123703931833
45,mut_micro,21711.0,331,28,43,4,71,0.2468898786668714
46,mut_micro,21408.0,328,27,43,4,70,0.24682515493243923
47,mut_micro,21408.0,328,27,43,4,70,0.24682515493243923
48,swap,21116.0,336,27,42,4,69,0.25796244423695425
49,mut_micro,21116.0,336,27,42,4,69,0.25796244423695425
50,mut_micro,20819.0,339,26,42,4,68,0.26078431372549027
51,mut_micro,20515.0,335,26,41,4,67,0.25891148015934606
52,mut_micro,20515.0,335,26,41,4,67,0.25891148015934606
53,mut_micro,20515.0,335,26,41,4,67,0.25891148015934606
54,mut_micro,20515.0,335,26,41,4,67,0.25891148015934606
55,mut_micro,19614.0,334,24,40,4,64,0.25980392156862747
56,mut_micro,19614.0,334,24,40,4,64,0.25980392156862747
57,mut_micro,19614.0,334,24,40,4,64,0.25980392156862747
58,swap,19321.0,341,24,39,4,63,0.2687536140461546
59,mut_micro,19321.0,341,24,39,4,63,0.2687536140461546
60,reassign,19321.0,341,24,39,4,63,0.2687536140461546
61,mut_micro,19321.0,341,24,39,4,63,0.2687536140461546
62,mut_micro,19321.0,341,24,39,4,63,0.2687536140461546
63,swap,19024.0,344,24,38,4,62,0.27397986221515636
64,swap,19024.0,344,24,38,4,62,0.27397986221515636
65,swap,19024.0,344,24,38,4,62,0.27397986221515636
66,mut_micro,19023.0,343,24,38,4,62,0.2731092436974789
67,swap,19023.0,343,24,38,4,62,0.2731092436974789
68,mut_micro,19023.0,343,24,38,4,62,0.2731092436974789
69,mut_micro,18424.0,344,23,37,4,60,0.27217806041335446
70,mut_micro,18121.0,341,22,37,4,59,0.2720653945224203
71,mut_micro,17520.0,340,20,37,4,57,0.2729369822795427
72,mut_micro,17520.0,340,20,37,4,57,0.2729369822795427
73,mut_micro,17520.0,340,20,37,4,57,0.2729369822795427
74,mut_micro,17520.0,340,20,37,4,57,0.2729369822795427
75,mut_micro,17520.0,340,20,37,4,57,0.2729369822795427
76,mut_micro,17516.0,336,20,37,4,57,0.26750700280112066
77,mut_micro,17497.0,337,20,37,3,57,0.269282779424767
78,mut_micro,17497.0,337,20,37,3,57,0.269282779424767
79,reassign,17497.0,337,20,37,3,57,0.269282779424767
80,mut_micro,17195.0,335,18,38,3,56,0.2698794557400797
81,mut_micro,17195.0,335,18,38,3,56,0.2698794557400797
82,reassign,17195.0,335,18,38,3,56,0.2698794557400797
83,swap,17195.0,335,18,38,3,56,0.2698794557400797
84,mut_micro,17195.0,335,18,38,3,56,0.2698794557400797
85,swap,17195.0,335,18,38,3,56,0.2698794557400797
86,mut_micro,17195.0,335,18,38,3,56,0.2698794557400797
87,mut_micro,17195.0,335,18,38,3,56,0.2698794557400797
88,swap,17195.0,335,18,38,3,56,0.2698794557400797
89,mut_micro,17195.0,335,18,38,3,56,0.2698794557400797
90,mut_micro,17195.0,335,18,38,3,56,0.2698794557400797
91,swap,16896.0,336,18,37,3,55,0.27238302728498826
92,mut_micro,16896.0,336,18,37,3,55,0.27238302728498826
93,swap,16896.0,336,18,37,3,55,0.27238302728498826
94,swap,16896.0,336,18,37,3,55,0.27238302728498826
95,swap,16896.0,336,18,37,3,55,0.27238302728498826
96,swap,16896.0,336,18,37,3,55,0.27238302728498826
97,swap,16896.0,336,18,37,3,55,0.27238302728498826
98,swap,16896.0,336,18,37,3,55,0.27238302728498826
99,swap,16896.0,336,18,37,3,55,0.27238302728498826
100,swap,16896.0,336,18,37,3,55,0.27238302728498826
101,swap,16896.0,336,18,37,3,55,0.27238302728498826
102,swap,16896.0,336,18,37,3,55,0.27238302728498826
103,swap,16600.0,340,18,36,3,54,0.2752437873545139
104,swap,16600.0,340,18,36,3,54,0.2752437873545139
105,swap,16600.0,340,18,36,3,54,0.2752437873545139
106,swap,16600.0,340,18,36,3,54,0.2752437873545139
107,swap,16600.0,340,18,36,3,54,0.2752437873545139
108,swap,16600.0,340,18,36,3,54,0.2752437873545139
109,swap,16600.0,340,18,36,3,54,0.2752437873545139
110,swap,16600.0,340,18,36,3,54,0.2752437873545139
111,swap,16600.0,340,18,36,3,54,0.2752437873545139
112,swap,16600.0,340,18,36,3,54,0.2752437873545139
113,swap,16600.0,340,18,36,3,54,0.2752437873545139
114,swap,16600.0,340,18,36,3,54,0.2752437873545139
115,swap,16600.0,340,18,36,3,54,0.2752437873545139
116,swap,16306.0,346,18,35,3,53,0.2847932651321397
117,mut_micro,16306.0,346,18,35,3,53,0.2847932651321397
118,swap,16306.0,346,18,35,3,53,0.2847932651321397
119,swap,16306.0,346,18,35,3,53,0.2847932651321397
120,swap,16306.0,346,18,35,3,53,0.2847932651321397
121,swap,16306.0,346,18,35,3,53,0.2847932651321397
122,swap,16306.0,346,18,35,3,53,0.2847932651321397
123,swap,16306.0,346,18,35,3,53,0.2847932651321397
124,swap,16306.0,346,18,35,3,53,0.2847932651321397
125,swap,16011.0,351,18,34,3,52,0.292416140009723
126,swap,15719.0,359,18,33,3,51,0.30160176746755046
127,swap,15719.0,359,18,33,3,51,0.30160176746755046
128,swap,15719.0,359,18,33,3,51,0.30160176746755046
129,swap,15719.0,359,18,33,3,51,0.30160176746755046
130,swap,15719.0,359,18,33,3,51,0.30160176746755046
131,swap,15719.0,359,18,33,3,51,0.30160176746755046
132,swap,15719.0,359,18,33,3,51,0.30160176746755046
133,swap,15719.0,359,18,33,3,51,0.30160176746755046
134,swap,15719.0,359,18,33,3,51,0.30160176746755046
135,swap,15719.0,359,18,33,3,51,0.30160176746755046
136,swap,15424.0,364,18,32,3,50,0.30565826330532225
137,swap,15131.0,371,18,31,3,49,0.31518321614360023
138,swap,15131.0,371,18,31,3,49,0.31518321614360023
139,swap,15131.0,371,18,31,3,49,0.31518321614360023
140,swap,15131.0,371,18,31,3,49,0.31518321614360023
141,swap,15131.0,371,18,31,3,49,0.31518321614360023
142,swap,15131.0,371,18,31,3,49,0.31518321614360023
143,swap,15131.0,371,18,31,3,49,0.31518321614360023
144,swap,15131.0,371,18,31,3,49,0.31518321614360023
145,swap,15131.0,371,18,31,3,49,0.31518321614360023
146,swap,15131.0,371,18,31,3,49,0.31518321614360023
147,swap,15131.0,371,18,31,3,49,0.31518321614360023
148,swap,15131.0,371,18,31,3,49,0.31518321614360023
149,swap,15131.0,371,18,31,3,49,0.31518321614360023
150,swap,15131.0,371,18,31,3,49,0.31518321614360023
151,swap,15131.0,371,18,31,3,49,0.31518321614360023
152,swap,15131.0,371,18,31,3,49,0.31518321614360023
153,swap,15131.0,371,18,31,3,49,0.31518321614360023
154,swap,15131.0,371,18,31,3,49,0.31518321614360023
155,swap,15131.0,371,18,31,3,49,0.31518321614360023
156,swap,15131.0,371,18,31,3,49,0.31518321614360023
157,swap,15131.0,371,18,31,3,49,0.31518321614360023
158,swap,15131.0,371,18,31,3,49,0.31518321614360023
159,swap,14833.0,373,18,30,3,48,0.3190443332758322
160,swap,14833.0,373,18,30,3,48,0.3190443332758322
161,swap,14833.0,373,18,30,3,48,0.3190443332758322
162,swap,14831.0,371,18,30,3,48,0.31518321614360023
163,swap,14831.0,371,18,30,3,48,0.31518321614360023
164,swap,14831.0,371,18,30,3,48,0.31518321614360023
165,swap,14831.0,371,18,30,3,48,0.31518321614360023
166,swap,14831.0,371,18,30,3,48,0.31518321614360023
167,swap,14831.0,371,18,30,3,48,0.31518321614360023
168,swap,14831.0,371,18,30,3,48,0.31518321614360023
169,swap,14831.0,371,18,30,3,48,0.31518321614360023
170,swap,14831.0,371,18,30,3,48,0.31518321614360023
171,swap,14831.0,371,18,30,3,48,0.31518321614360023
172,swap,14831.0,371,18,30,3,48,0.31518321614360023
173,swap,14831.0,371,18,30,3,48,0.31518321614360023
174,swap,14831.0,371,18,30,3,48,0.31518321614360023
175,swap,14831.0,371,18,30,3,48,0.31518321614360023
176,swap,14831.0,371,18,30,3,48,0.31518321614360023
177,swap,14831.0,371,18,30,3,48,0.31518321614360023
178,mut_micro,14529.0,369,16,31,3,47,0.31597044614947417
179,swap,14529.0,369,16,31,3,47,0.31597044614947417
180,swap,14529.0,369,16,31,3,47,0.31597044614947417
181,swap,14529.0,369,16,31,3,47,0.31597044614947417
182,swap,14529.0,369,16,31,3,47,0.31597044614947417
183,swap,14529.0,369,16,31,3,47,0.31597044614947417
184,swap,14529.0,369,16,31,3,47,0.31597044614947417
185,swap,14529.0,369,16,31,3,47,0.31597044614947417
186,mut_micro,14529.0,369,16,31,3,47,0.31597044614947417
187,swap,14529.0,369,16,31,3,47,0.31597044614947417
188,swap,14529.0,369,16,31,3,47,0.31597044614947417
189,mut_micro,14529.0,369,16,31,3,47,0.31597044614947417
190,swap,14528.0,368,16,31,3,47,0.31967584721749964
191,swap,14528.0,368,16,31,3,47,0.31967584721749964
192,swap,14528.0,368,16,31,3,47,0.31967584721749964
193,swap,14528.0,368,16,31,3,47,0.31967584721749964
194,swap,14528.0,368,16,31,3,47,0.31967584721749964
195,swap,14231.0,371,16,30,3,46,0.32421540044589264
196,swap,14231.0,371,16,30,3,46,0.32421540044589264
197,swap,14231.0,371,16,30,3,46,0.32421540044589264
198,swap,14231.0,371,16,30,3,46,0.32421540044589264
199,mut_micro,14231.0,371,16,30,3,46,0.32421540044589264
200,swap,14231.0,371,16,30,3,46,0.32421540044589264
201,swap,14231.0,371,16,30,3,46,0.32421540044589264
202,swap,14231.0,371,16,30,3,46,0.32421540044589264
203,swap,13940.0,380,16,29,3,45,0.33257015381002697
204,swap,13940.0,380,16,29,3,45,0.33257015381002697
205,swap,13940.0,380,16,29,3,45,0.33257015381002697
206,swap,13940.0,380,16,29,3,45,0.33257015381002697
207,swap,13646.0,386,16,28,3,44,0.3410449545671927
208,swap,13646.0,386,16,28,3,44,0.3410449545671927
209,swap,13646.0,386,16,28,3,44,0.3410449545671927
210,reassign,13342.0,382,15,28,3,43,0.33669974013701864
211,swap,13342.0,382,15,28,3,43,0.33669974013701864
212,mut_micro,13342.0,382,15,28,3,43,0.33669974013701864
213,swap,13342.0,382,15,28,3,43,0.33669974013701864
214,swap,13342.0,382,15,28,3,43,0.33669974013701864
215,swap,13045.0,385,15,27,3,42,0.3423028785982477
216,swap,13045.0,385,15,27,3,42,0.3423028785982477
217,mut_micro,13045.0,385,15,27,3,42,0.3423028785982477
218,swap,13045.0,385,15,27,3,42,0.3423028785982477
219,swap,13045.0,385,15,27,3,42,0.3423028785982477
220,swap,13045.0,385,15,27,3,42,0.3423028785982477
221,swap,13045.0,385,15,27,3,42,0.3423028785982477
222,swap,13045.0,385,15,27,3,42,0.3423028785982477
223,swap,13045.0,385,15,27,3,42,0.3423028785982477
224,swap,13045.0,385,15,27,3,42,0.3423028785982477
225,swap,13045.0,385,15,27,3,42,0.3423028785982477
226,swap,13045.0,385,15,27,3,42,0.3423028785982477
227,swap,13045.0,385,15,27,3,42,0.3423028785982477
228,swap,13045.0,385,15,27,3,42,0.3423028785982477
229,swap,13045.0,385,15,27,3,42,0.3423028785982477
230,swap,13045.0,385,15,27,3,42,0.3423028785982477
231,swap,13045.0,385,15,27,3,42,0.3423028785982477
232,swap,13045.0,385,15,27,3,42,0.3423028785982477
233,swap,12747.0,387,15,26,3,41,0.34571565629309825
234,swap,12747.0,387,15,26,3,41,0.34571565629309825
235,swap,12747.0,387,15,26,3,41,0.34571565629309825
236,swap,12747.0,387,15,26,3,41,0.34571565629309825
237,swap,12745.0,385,15,26,3,41,0.34361404136122536
238,swap,12745.0,385,15,26,3,41,0.34361404136122536
239,swap,12745.0,385,15,26,3,41,0.34361404136122536
240,swap,12745.0,385,15,26,3,41,0.34361404136122536
241,swap,12745.0,385,15,26,3,41,0.34361404136122536
242,swap,12745.0,385,15,26,3,41,0.34361404136122536
243,swap,12745.0,385,15,26,3,41,0.34361404136122536
244,swap,12745.0,385,15,26,3,41,0.34361404136122536
245,swap,12745.0,385,15,26,3,41,0.34361404136122536
246,swap,12745.0,385,15,26,3,41,0.34361404136122536
247,swap,12745.0,385,15,26,3,41,0.34361404136122536
248,swap,12745.0,385,15,26,3,41,0.34361404136122536
249,reassign,12745.0,385,15,26,3,41,0.34361404136122536
250,swap,12745.0,385,15,26,3,41,0.34361404136122536
251,mut_micro,12745.0,385,15,26,3,41,0.34361404136122536
252,mut_micro,12745.0,385,15,26,3,41,0.34361404136122536
253,swap,12745.0,385,15,26,3,41,0.34361404136122536
254,swap,12745.0,385,15,26,3,41,0.34361404136122536
255,mut_micro,12745.0,385,15,26,3,41,0.34361404136122536
256,swap,12745.0,385,15,26,3,41,0.34361404136122536
257,swap,12745.0,385,15,26,3,41,0.34361404136122536
258,swap,12745.0,385,15,26,3,41,0.34361404136122536
259,swap,12745.0,385,15,26,3,41,0.34361404136122536
260,swap,12745.0,385,15,26,3,41,0.34361404136122536
261,reassign,12745.0,385,15,26,3,41,0.34361404136122536
262,swap,12745.0,385,15,26,3,41,0.34361404136122536
263,mut_micro,12745.0,385,15,26,3,41,0.34361404136122536
264,mut_micro,12744.0,384,15,26,3,41,0.34159239453357104
265,swap,12744.0,384,15,26,3,41,0.34159239453357104
266,swap,12744.0,384,15,26,3,41,0.34159239453357104
267,swap,12744.0,384,15,26,3,41,0.34159239453357104
268,swap,12448.0,388,15,25,3,40,0.34590400577408886
269,swap,12448.0,388,15,25,3,40,0.34590400577408886
270,swap,12448.0,388,15,25,3,40,0.34590400577408886
271,swap,12448.0,388,15,25,3,40,0.34590400577408886
272,swap,12448.0,388,15,25,3,40,0.34590400577408886
273,swap,12448.0,388,15,25,3,40,0.34590400577408886
274,swap,12448.0,388,15,25,3,40,0.34590400577408886
275,swap,12448.0,388,15,25,3,40,0.34590400577408886
276,swap,12448.0,388,15,25,3,40,0.34590400577408886
277,swap,12448.0,388,15,25,3,40,0.34590400577408886
278,swap,12447.0,387,15,25,3,40,0.3445163998321041
279,swap,12446.0,386,15,25,3,40,0.3430774748923959
280,swap,12446.0,386,15,25,3,40,0.3430774748923959
281,swap,12446.0,386,15,25,3,40,0.3430774748923959
282,mut_micro,11847.0,387,14,24,3,38,0.34505606523955157
283,mut_micro,11847.0,387,14,24,3,38,0.34505606523955157
284,mut_micro,11847.0,387,14,24,3,38,0.34505606523955157
285,mut_micro,11547.0,387,13,24,3,37,0.34505606523955157
286,mut_micro,11547.0,387,13,24,3,37,0.34505606523955157
287,swap,11254.0,394,13,23,3,36,0.35324754901960786
288,swap,11254.0,394,13,23,3,36,0.35324754901960786
289,swap,11254.0,394,13,23,3,36,0.35324754901960786
290,swap,11254.0,394,13,23,3,36,0.35324754901960786
291,swap,11254.0,394,13,23,3,36,0.35324754901960786
292,swap,11254.0,394,13,23,3,36,0.35324754901960786
293,swap,11254.0,394,13,23,3,36,0.35324754901960786
294,swap,11254.0,394,13,23,3,36,0.35324754901960786
295,swap,10964.0,404,13,22,3,35,0.3593295382669197
296,swap,10964.0,404,13,22,3,35,0.3593295382669197
297,swap,10964.0,404,13,22,3,35,0.3593295382669197
298,swap,10964.0,404,13,22,3,35,0.3593295382669197
299,swap,10964.0,404,13,22,3,35,0.3593295382669197
300,swap,10964.0,404,13,22,3,35,0.3593295382669197
301,swap,10964.0,404,13,22,3,35,0.3593295382669197
302,swap,10964.0,404,13,22,3,35,0.3593295382669197
303,swap,10964.0,404,13,22,3,35,0.3593295382669197
304,swap,10964.0,404,13,22,3,35,0.3593295382669197
305,swap,10964.0,404,13,22,3,35,0.3593295382669197
306,swap,10964.0,404,13,22,3,35,0.3593295382669197
307,swap,10964.0,404,13,22,3,35,0.3593295382669197
308,reassign,10964.0,404,13,22,3,35,0.3593295382669197
309,swap,10964.0,404,13,22,3,35,0.3593295382669197
310,swap,10964.0,404,13,22,3,35,0.3593295382669197
311,swap,10963.0,403,13,22,3,35,0.3592774730470966
312,swap,10963.0,403,13,22,3,35,0.3592774730470966
313,swap,10963.0,403,13,22,3,35,0.3592774730470966
314,swap,10963.0,403,13,22,3,35,0.3592774730470966
315,swap,10963.0,403,13,22,3,35,0.3592774730470966
316,swap,10958.0,398,13,22,3,35,0.3589600397120873
317,swap,10958.0,398,13,22,3,35,0.3589600397120873
318,swap,10958.0,398,13,22,3,35,0.3589600397120873
319,swap,10958.0,398,13,22,3,35,0.3589600397120873
320,swap,10958.0,398,13,22,3,35,0.3589600397120873
321,swap,10958.0,398,13,22,3,35,0.3589600397120873
322,swap,10958.0,398,13,22,3,35,0.3589600397120873
323,swap,10958.0,398,13,22,3,35,0.3589600397120873
324,swap,10958.0,398,13,22,3,35,0.3589600397120873
325,swap,10958.0,398,13,22,3,35,0.3589600397120873
326,reassign,10958.0,398,13,22,3,35,0.3589600397120873
327,swap,10958.0,398,13,22,3,35,0.3589600397120873
328,swap,10958.0,398,13,22,3,35,0.3589600397120873
329,swap,10958.0,398,13,22,3,35,0.3589600397120873
330,swap,10958.0,398,13,22,3,35,0.3589600397120873
331,swap,10958.0,398,13,22,3,35,0.3589600397120873
332,swap,10958.0,398,13,22,3,35,0.3589600397120873
333,swap,10958.0,398,13,22,3,35,0.3589600397120873
334,swap,10958.0,398,13,22,3,35,0.3589600397120873
335,swap,10958.0,398,13,22,3,35,0.3589600397120873
336,swap,10958.0,398,13,22,3,35,0.3589600397120873
337,swap,10667.0,407,13,21,3,34,0.36568308105000963
338,swap,10667.0,407,13,21,3,34,0.36568308105000963
339,swap,10667.0,407,13,21,3,34,0.36568308105000963
340,swap,10667.0,407,13,21,3,34,0.36568308105000963
341,swap,10667.0,407,13,21,3,34,0.36568308105000963
342,swap,10667.0,407,13,21,3,34,0.36568308105000963
343,swap,10667.0,407,13,21,3,34,0.36568308105000963
344,swap,10667.0,407,13,21,3,34,0.36568308105000963
345,swap,10667.0,407,13,21,3,34,0.36568308105000963
346,swap,10666.0,406,13,21,3,34,0.36560988031576264
347,swap,10666.0,406,13,21,3,34,0.36560988031576264
348,swap,10666.0,406,13,21,3,34,0.36560988031576264
349,swap,10666.0,406,13,21,3,34,0.36560988031576264
350,swap,10666.0,406,13,21,3,34,0.36560988031576264
351,swap,10666.0,406,13,21,3,34,0.36560988031576264
352,swap,10666.0,406,13,21,3,34,0.36560988031576264
353,swap,10666.0,406,13,21,3,34,0.36560988031576264
354,swap,10666.0,406,13,21,3,34,0.36560988031576264
355,swap,10666.0,406,13,21,3,34,0.36560988031576264
356,swap,10666.0,406,13,21,3,34,0.36560988031576264
357,swap,10666.0,406,13,21,3,34,0.36560988031576264
358,swap,10666.0,406,13,21,3,34,0.36560988031576264
359,swap,10665.0,405,13,21,3,34,0.3687733993273684
360,swap,10665.0,405,13,21,3,34,0.3687733993273684
361,swap,10370.0,410,13,20,3,33,0.3715815273477812
362,swap,10370.0,410,13,20,3,33,0.3715815273477812
363,swap,10370.0,410,13,20,3,33,0.3715815273477812
364,swap,10370.0,410,13,20,3,33,0.3715815273477812
365,swap,10370.0,410,13,20,3,33,0.3715815273477812
366,swap,10370.0,410,13,20,3,33,0.3715815273477812
367,swap,10370.0,410,13,20,3,33,0.3715815273477812
368,swap,10370.0,410,13,20,3,33,0.3715815273477812
369,swap,10370.0,410,13,20,3,33,0.3715815273477812
370,swap,10366.0,406,13,20,3,33,0.367965367965368
371,mut_micro,10366.0,406,13,20,3,33,0.367965367965368
372,swap,10366.0,406,13,20,3,33,0.367965367965368
373,swap,10366.0,406,13,20,3,33,0.367965367965368
374,swap,10366.0,406,13,20,3,33,0.367965367965368
375,swap,10366.0,406,13,20,3,33,0.367965367965368
376,swap,10366.0,406,13,20,3,33,0.367965367965368
377,mut_micro,10366.0,406,13,20,3,33,0.367965367965368
378,swap,10366.0,406,13,20,3,33,0.367965367965368
379,swap,10366.0,406,13,20,3,33,0.367965367965368
380,swap,10366.0,406,13,20,3,33,0.367965367965368
381,mut_micro,10366.0,406,13,20,3,33,0.367965367965368
382,swap,10366.0,406,13,20,3,33,0.367965367965368
383,swap,10366.0,406,13,20,3,33,0.367965367965368
384,swap,10366.0,406,13,20,3,33,0.367965367965368
385,swap,10366.0,406,13,20,3,33,0.367965367965368
386,swap,10366.0,406,13,20,3,33,0.367965367965368
387,swap,10366.0,406,13,20,3,33,0.367965367965368
388,swap,10366.0,406,13,20,3,33,0.367965367965368
389,swap,10366.0,406,13,20,3,33,0.367965367965368
390,swap,10366.0,406,13,20,3,33,0.367965367965368
391,swap,10366.0,406,13,20,3,33,0.367965367965368
392,swap,10366.0,406,13,20,3,33,0.367965367965368
393,reassign,10345.0,405,13,20,2,33,0.3687733993273684
394,swap,10344.0,404,13,20,2,33,0.3645161290322581
395,swap,10344.0,404,13,20,2,33,0.3645161290322581
396,swap,10344.0,404,13,20,2,33,0.3645161290322581
397,swap,10344.0,404,13,20,2,33,0.3645161290322581
398,swap,10344.0,404,13,20,2,33,0.3645161290322581
399,swap,10341.0,401,13,20,2,33,0.3608031071853661
400,swap,10341.0,401,13,20,2,33,0.3608031071853661
401,swap,10341.0,401,13,20,2,33,0.3608031071853661
402,swap,10335.0,395,13,20,2,33,0.3536480422890159
403,swap,10335.0,395,13,20,2,33,0.3536480422890159
404,swap,10335.0,395,13,20,2,33,0.3536480422890159
405,swap,10335.0,395,13,20,2,33,0.3536480422890159
406,swap,10335.0,395,13,20,2,33,0.3536480422890159
407,swap,10335.0,395,13,20,2,33,0.3536480422890159
408,swap,10335.0,395,13,20,2,33,0.3536480422890159
409,swap,10335.0,395,13,20,2,33,0.3536480422890159
410,swap,10335.0,395,13,20,2,33,0.3536480422890159
411,swap,10335.0,395,13,20,2,33,0.3536480422890159
412,swap,10335.0,395,13,20,2,33,0.3536480422890159
413,swap,10335.0,395,13,20,2,33,0.3536480422890159
414,swap,10335.0,395,13,20,2,33,0.3536480422890159
415,swap,10335.0,395,13,20,2,33,0.3536480422890159
416,swap,10335.0,395,13,20,2,33,0.3536480422890159
417,swap,10333.0,393,13,20,2,33,0.35150571131879554
418,swap,10333.0,393,13,20,2,33,0.35150571131879554
419,swap,10333.0,393,13,20,2,33,0.35150571131879554
420,swap,10333.0,393,13,20,2,33,0.35150571131879554
421,swap,10333.0,393,13,20,2,33,0.35150571131879554
422,reassign,10333.0,393,13,20,2,33,0.35150571131879554
423,swap,10333.0,393,13,20,2,33,0.35150571131879554
424,swap,10333.0,393,13,20,2,33,0.35150571131879554
425,swap,10333.0,393,13,20,2,33,0.35150571131879554
426,reassign,10333.0,393,13,20,2,33,0.35150571131879554
427,reassign,10333.0,393,13,20,2,33,0.35150571131879554
428,swap,10333.0,393,13,20,2,33,0.35150571131879554
429,swap,10333.0,393,13,20,2,33,0.35150571131879554
430,swap,10333.0,393,13,20,2,33,0.35150571131879554
431,swap,10333.0,393,13,20,2,33,0.35150571131879554
432,mut_micro,10333.0,393,13,20,2,33,0.35150571131879554
433,swap,10333.0,393,13,20,2,33,0.35150571131879554
434,swap,10333.0,393,13,20,2,33,0.35150571131879554
435,swap,10333.0,393,13,20,2,33,0.35150571131879554
436,swap,10333.0,393,13,20,2,33,0.35150571131879554
437,swap,10333.0,393,13,20,2,33,0.35150571131879554
438,swap,10333.0,393,13,20,2,33,0.35150571131879554
439,swap,10333.0,393,13,20,2,33,0.35150571131879554
440,swap,10333.0,393,13,20,2,33,0.35150571131879554
441,swap,10333.0,393,13,20,2,33,0.35150571131879554
442,swap,10333.0,393,13,20,2,33,0.35150571131879554
443,swap,10333.0,393,13,20,2,33,0.35150571131879554
444,swap,10333.0,393,13,20,2,33,0.35150571131879554
445,swap,10333.0,393,13,20,2,33,0.35150571131879554
446,swap,10333.0,393,13,20,2,33,0.35150571131879554
447,swap,10333.0,393,13,20,2,33,0.35150571131879554
448,swap,10333.0,393,13,20,2,33,0.35150571131879554
449,swap,10333.0,393,13,20,2,33,0.35150571131879554
450,swap,10333.0,393,13,20,2,33,0.35150571131879554
451,swap,10333.0,393,13,20,2,33,0.35150571131879554
452,reassign,10333.0,393,13,20,2,33,0.35150571131879554
453,swap,10333.0,393,13,20,2,33,0.35150571131879554
454,mut_micro,10333.0,393,13,20,2,33,0.35150571131879554
455,swap,10333.0,393,13,20,2,33,0.35150571131879554
456,swap,10333.0,393,13,20,2,33,0.35150571131879554
457,swap,10333.0,393,13,20,2,33,0.35150571131879554
458,mut_micro,10328.0,388,12,21,2,33,0.34812943582340905
459,swap,10328.0,388,12,21,2,33,0.34812943582340905
460,swap,10328.0,388,12,21,2,33,0.34812943582340905
461,swap,10328.0,388,12,21,2,33,0.34812943582340905
462,swap,10328.0,388,12,21,2,33,0.34812943582340905
463,swap,10328.0,388,12,21,2,33,0.34812943582340905
464,swap,10328.0,388,12,21,2,33,0.34812943582340905
465,swap,10328.0,388,12,21,2,33,0.34812943582340905
466,swap,10328.0,388,12,21,2,33,0.34812943582340905
467,swap,10328.0,388,12,21,2,33,0.34812943582340905
468,swap,10323.0,383,12,21,2,33,0.3445589716249038
469,swap,10323.0,383,12,21,2,33,0.3445589716249038
470,swap,10323.0,383,12,21,2,33,0.3445589716249038
471,swap,10323.0,383,12,21,2,33,0.3445589716249038
472,swap,10030.0,390,12,20,2,32,0.3514282256112322
473,swap,10030.0,390,12,20,2,32,0.3514282256112322
474,swap,10030.0,390,12,20,2,32,0.3514282256112322
475,swap,10030.0,390,12,20,2,32,0.3514282256112322
476,swap,10030.0,390,12,20,2,32,0.3514282256112322
477,swap,10030.0,390,12,20,2,32,0.3514282256112322
478,swap,10030.0,390,12,20,2,32,0.3514282256112322
479,swap,10030.0,390,12,20,2,32,0.3514282256112322
480,swap,10030.0,390,12,20,2,32,0.3514282256112322
481,swap,10030.0,390,12,20,2,32,0.3514282256112322
482,swap,10029.0,389,12,20,2,32,0.3512217194570136
483,mut_micro,10029.0,389,12,20,2,32,0.3512217194570136
484,swap,10029.0,389,12,20,2,32,0.3512217194570136
485,swap,10029.0,389,12,20,2,32,0.3512217194570136
486,swap,10029.0,389,12,20,2,32,0.3512217194570136
487,swap,10029.0,389,12,20,2,32,0.3512217194570136
488,swap,10029.0,389,12,20,2,32,0.3512217194570136
489,swap,10027.0,387,12,20,2,32,0.3479342807459375
490,swap,10027.0,387,12,20,2,32,0.3479342807459375
491,swap,9733.0,393,12,19,2,31,0.35278846741188696
492,swap,9733.0,393,12,19,2,31,0.35278846741188696
493,swap,9733.0,393,12,19,2,31,0.35278846741188696
494,swap,9733.0,393,12,19,2,31,0.35278846741188696
495,swap,9733.0,393,12,19,2,31,0.35278846741188696
496,swap,9731.0,391,12,19,2,31,0.34951132155648634
497,swap,9731.0,391,12,19,2,31,0.34951132155648634
498,swap,9731.0,391,12,19,2,31,0.34951132155648634
499,swap,9436.0,396,12,18,2,30,0.3527561968183501
500,swap,9436.0,396,12,18,2,30,0.3527561968183501
501,swap,9436.0,396,12,18,2,30,0.3527561968183501
502,swap,9436.0,396,12,18,2,30,0.3527561968183501
503,swap,9436.0,396,12,18,2,30,0.3527561968183501
504,swap,9436.0,396,12,18,2,30,0.3527561968183501
505,swap,9436.0,396,12,18,2,30,0.3527561968183501
506,swap,9436.0,396,12,18,2,30,0.3527561968183501
507,swap,9436.0,396,12,18,2,30,0.3527561968183501
508,swap,9436.0,396,12,18,2,30,0.3527561968183501
509,swap,9436.0,396,12,18,2,30,0.3527561968183501
510,swap,9434.0,394,12,18,2,30,0.35189950980392154
511,swap,9434.0,394,12,18,2,30,0.35189950980392154
512,swap,9434.0,394,12,18,2,30,0.35189950980392154
513,swap,9434.0,394,12,18,2,30,0.35189950980392154
514,swap,9434.0,394,12,18,2,30,0.35189950980392154
515,swap,9434.0,394,12,18,2,30,0.35189950980392154
516,swap,9434.0,394,12,18,2,30,0.35189950980392154
517,swap,9434.0,394,12,18,2,30,0.35189950980392154
518,mut_micro,9434.0,394,12,18,2,30,0.35189950980392154
519,swap,9434.0,394,12,18,2,30,0.35189950980392154
520,swap,9434.0,394,12,18,2,30,0.35189950980392154
521,swap,9135.0,395,12,17,2,29,0.35370950888192265
522,swap,9135.0,395,12,17,2,29,0.35370950888192265
523,swap,9135.0,395,12,17,2,29,0.35370950888192265
524,swap,9135.0,395,12,17,2,29,0.35370950888192265
525,swap,9135.0,395,12,17,2,29,0.35370950888192265
526,swap,9135.0,395,12,17,2,29,0.35370950888192265
527,swap,9135.0,395,12,17,2,29,0.35370950888192265
528,swap,9135.0,395,12,17,2,29,0.35370950888192265
529,swap,9135.0,395,12,17,2,29,0.35370950888192265
530,swap,9135.0,395,12,17,2,29,0.35370950888192265
531,swap,9135.0,395,12,17,2,29,0.35370950888192265
532,swap,9135.0,395,12,17,2,29,0.35370950888192265
533,swap,9135.0,395,12,17,2,29,0.35370950888192265
534,swap,9135.0,395,12,17,2,29,0.35370950888192265
535,mut_micro,9135.0,395,12,17,2,29,0.35370950888192265
536,swap,9135.0,395,12,17,2,29,0.35370950888192265
537,swap,9135.0,395,12,17,2,29,0.35370950888192265
538,swap,9135.0,395,12,17,2,29,0.35370950888192265
539,swap,9135.0,395,12,17,2,29,0.35370950888192265
540,swap,9135.0,395,12,17,2,29,0.35370950888192265
541,swap,9133.0,393,12,17,2,29,0.3504672897196263
542,swap,9133.0,393,12,17,2,29,0.3504672897196263
543,swap,8840.0,400,12,16,2,28,0.35681278880979134
544,swap,8840.0,400,12,16,2,28,0.35681278880979134
545,swap,8840.0,400,12,16,2,28,0.35681278880979134
546,swap,8840.0,400,12,16,2,28,0.35681278880979134
547,mut_micro,8840.0,400,12,16,2,28,0.35681278880979134
548,swap,8840.0,400,12,16,2,28,0.35681278880979134
549,swap,8840.0,400,12,16,2,28,0.35681278880979134
550,swap,8840.0,400,12,16,2,28,0.35681278880979134
551,mut_micro,8840.0,400,12,16,2,28,0.35681278880979134
552,swap,8840.0,400,12,16,2,28,0.35681278880979134
553,swap,8837.0,397,12,16,2,28,0.3568689305375148
554,swap,8837.0,397,12,16,2,28,0.3568689305375148
555,swap,8837.0,397,12,16,2,28,0.3568689305375148
556,swap,8837.0,397,12,16,2,28,0.3568689305375148
557,swap,8837.0,397,12,16,2,28,0.3568689305375148
558,swap,8837.0,397,12,16,2,28,0.3568689305375148
559,swap,8837.0,397,12,16,2,28,0.3568689305375148
560,swap,8837.0,397,12,16,2,28,0.3568689305375148
561,swap,8837.0,397,12,16,2,28,0.3568689305375148
562,swap,8837.0,397,12,16,2,28,0.3568689305375148
563,swap,8837.0,397,12,16,2,28,0.3568689305375148
564,swap,8837.0,397,12,16,2,28,0.3568689305375148
565,swap,8837.0,397,12,16,2,28,0.3568689305375148
566,swap,8837.0,397,12,16,2,28,0.3568689305375148
567,swap,8837.0,397,12,16,2,28,0.3568689305375148
568,swap,8837.0,397,12,16,2,28,0.3568689305375148
569,swap,8837.0,397,12,16,2,28,0.3568689305375148
570,swap,8837.0,397,12,16,2,28,0.3568689305375148
571,swap,8837.0,397,12,16,2,28,0.3568689305375148
572,swap,8837.0,397,12,16,2,28,0.3568689305375148
573,swap,8837.0,397,12,16,2,28,0.3568689305375148
574,swap,8837.0,397,12,16,2,28,0.3568689305375148
575,swap,8837.0,397,12,16,2,28,0.3568689305375148
576,swap,8837.0,397,12,16,2,28,0.3568689305375148
577,swap,8837.0,397,12,16,2,28,0.3568689305375148
578,swap,8837.0,397,12,16,2,28,0.3568689305375148
579,swap,8837.0,397,12,16,2,28,0.3568689305375148
580,swap,8837.0,397,12,16,2,28,0.3568689305375148
581,swap,8837.0,397,12,16,2,28,0.3568689305375148
582,swap,8837.0,397,12,16,2,28,0.3568689305375148
583,swap,8837.0,397,12,16,2,28,0.3568689305375148
584,swap,8837.0,397,12,16,2,28,0.3568689305375148
585,swap,8837.0,397,12,16,2,28,0.3568689305375148
586,swap,8837.0,397,12,16,2,28,0.3568689305375148
587,swap,8837.0,397,12,16,2,28,0.3568689305375148
588,swap,8837.0,397,12,16,2,28,0.3568689305375148
589,mut_micro,8837.0,397,12,16,2,28,0.3568689305375148
590,swap,8837.0,397,12,16,2,28,0.3568689305375148
591,swap,8837.0,397,12,16,2,28,0.3568689305375148
592,swap,8837.0,397,12,16,2,28,0.3568689305375148
593,swap,8837.0,397,12,16,2,28,0.3568689305375148
594,swap,8837.0,397,12,16,2,28,0.3568689305375148
595,swap,8835.0,395,12,16,2,28,0.35752043764214153
596,reassign,8835.0,395,12,16,2,28,0.35752043764214153
597,swap,8834.0,394,12,16,2,28,0.35612745098039206
598,swap,8834.0,394,12,16,2,28,0.35612745098039206
599,swap,8834.0,394,12,16,2,28,0.35612745098039206
600,swap,8834.0,394,12,16,2,28,0.35612745098039206
601,swap,8834.0,394,12,16,2,28,0.35612745098039206
602,swap,8834.0,394,12,16,2,28,0.35612745098039206
603,swap,8834.0,394,12,16,2,28,0.35612745098039206
604,swap,8834.0,394,12,16,2,28,0.35612745098039206
605,mut_micro,8834.0,394,12,16,2,28,0.35612745098039206
606,swap,8834.0,394,12,16,2,28,0.35612745098039206
607,swap,8834.0,394,12,16,2,28,0.35612745098039206
608,mut_micro,8834.0,394,12,16,2,28,0.35612745098039206
609,swap,8834.0,394,12,16,2,28,0.35612745098039206
610,mut_micro,8834.0,394,12,16,2,28,0.35612745098039206
611,mut_micro,8834.0,394,12,16,2,28,0.35612745098039206
612,reassign,8834.0,394,12,16,2,28,0.35612745098039206
613,swap,8834.0,394,12,16,2,28,0.35612745098039206
614,swap,8833.0,393,12,16,2,28,0.35205546393012044
615,swap,8833.0,393,12,16,2,28,0.35205546393012044
616,swap,8833.0,393,12,16,2,28,0.35205546393012044
617,swap,8833.0,393,12,16,2,28,0.35205546393012044
618,swap,8833.0,393,12,16,2,28,0.35205546393012044
619,swap,8833.0,393,12,16,2,28,0.35205546393012044
620,swap,8833.0,393,12,16,2,28,0.35205546393012044
621,swap,8833.0,393,12,16,2,28,0.35205546393012044
622,swap,8833.0,393,12,16,2,28,0.35205546393012044
623,swap,8833.0,393,12,16,2,28,0.35205546393012044
624,swap,8833.0,393,12,16,2,28,0.35205546393012044
625,swap,8833.0,393,12,16,2,28,0.35205546393012044
626,swap,8833.0,393,12,16,2,28,0.35205546393012044
627,mut_micro,8833.0,393,12,16,2,28,0.35205546393012044
628,reassign,8833.0,393,12,16,2,28,0.35205546393012044
629,swap,8833.0,393,12,16,2,28,0.35205546393012044
630,swap,8833.0,393,12,16,2,28,0.35205546393012044
631,swap,8833.0,393,12,16,2,28,0.35205546393012044
632,swap,8833.0,393,12,16,2,28,0.35205546393012044
633,swap,8833.0,393,12,16,2,28,0.35205546393012044
634,swap,8833.0,393,12,16,2,28,0.35205546393012044
635,swap,8833.0,393,12,16,2,28,0.35205546393012044
636,swap,8833.0,393,12,16,2,28,0.35205546393012044
637,swap,8833.0,393,12,16,2,28,0.35205546393012044
638,swap,8833.0,393,12,16,2,28,0.35205546393012044
639,swap,8833.0,393,12,16,2,28,0.35205546393012044
640,swap,8833.0,393,12,16,2,28,0.35205546393012044
641,swap,8833.0,393,12,16,2,28,0.35205546393012044
642,swap,8833.0,393,12,16,2,28,0.35205546393012044
643,swap,8540.0,400,12,15,2,27,0.3583739228175345
644,swap,8540.0,400,12,15,2,27,0.3583739228175345
645,swap,8540.0,400,12,15,2,27,0.3583739228175345
646,swap,8540.0,400,12,15,2,27,0.3583739228175345
647,swap,8540.0,400,12,15,2,27,0.3583739228175345
648,swap,8540.0,400,12,15,2,27,0.3583739228175345
649,swap,8540.0,400,12,15,2,27,0.3583739228175345
650,swap,8540.0,400,12,15,2,27,0.3583739228175345
651,swap,8540.0,400,12,15,2,27,0.3583739228175345
652,swap,8540.0,400,12,15,2,27,0.3583739228175345
653,swap,8539.0,399,12,15,2,27,0.35695611577964514
654,swap,8539.0,399,12,15,2,27,0.35695611577964514
655,swap,8539.0,399,12,15,2,27,0.35695611577964514
656,swap,8538.0,398,12,15,2,27,0.3579051873914123
657,swap,8538.0,398,12,15,2,27,0.3579051873914123
658,swap,8538.0,398,12,15,2,27,0.3579051873914123
659,swap,8538.0,398,12,15,2,27,0.3579051873914123
660,swap,8244.0,404,12,14,2,26,0.36489563567362426
661,swap,8244.0,404,12,14,2,26,0.36489563567362426
662,swap,8244.0,404,12,14,2,26,0.36489563567362426
663,swap,8239.0,399,12,14,2,26,0.3618736383442266
664,swap,8239.0,399,12,14,2,26,0.3618736383442266
665,swap,8239.0,399,12,14,2,26,0.3618736383442266
666,swap,8239.0,399,12,14,2,26,0.3618736383442266
667,swap,8239.0,399,12,14,2,26,0.3618736383442266
668,swap,8239.0,399,12,14,2,26,0.3618736383442266
669,swap,8239.0,399,12,14,2,26,0.3618736383442266
670,swap,8239.0,399,12,14,2,26,0.3618736383442266
671,swap,8239.0,399,12,14,2,26,0.3618736383442266
672,mut_micro,8239.0,399,12,14,2,26,0.3618736383442266
673,swap,8239.0,399,12,14,2,26,0.3618736383442266
674,swap,8239.0,399,12,14,2,26,0.3618736383442266
675,swap,8239.0,399,12,14,2,26,0.3618736383442266
676,swap,8239.0,399,12,14,2,26,0.3618736383442266
677,swap,8239.0,399,12,14,2,26,0.3618736383442266
678,reassign,8239.0,399,12,14,2,26,0.3618736383442266
679,swap,8239.0,399,12,14,2,26,0.3618736383442266
680,swap,8239.0,399,12,14,2,26,0.3618736383442266
681,swap,8239.0,399,12,14,2,26,0.3618736383442266
682,swap,8239.0,399,12,14,2,26,0.3618736383442266
683,swap,8239.0,399,12,14,2,26,0.3618736383442266
684,swap,8239.0,399,12,14,2,26,0.3618736383442266
685,swap,8239.0,399,12,14,2,26,0.3618736383442266
686,swap,8239.0,399,12,14,2,26,0.3618736383442266
687,reassign,8239.0,399,12,14,2,26,0.3618736383442266
688,swap,8239.0,399,12,14,2,26,0.3618736383442266
689,swap,8239.0,399,12,14,2,26,0.3618736383442266
690,swap,8239.0,399,12,14,2,26,0.3618736383442266
691,swap,8239.0,399,12,14,2,26,0.3618736383442266
692,swap,8239.0,399,12,14,2,26,0.3618736383442266
693,swap,8239.0,399,12,14,2,26,0.3618736383442266
694,swap,8239.0,399,12,14,2,26,0.3618736383442266
695,swap,8239.0,399,12,14,2,26,0.3618736383442266
696,swap,8239.0,399,12,14,2,26,0.3618736383442266
697,swap,8239.0,399,12,14,2,26,0.3618736383442266
698,swap,8239.0,399,12,14,2,26,0.3618736383442266
699,mut_micro,8239.0,399,12,14,2,26,0.3618736383442266
700,swap,8239.0,399,12,14,2,26,0.3618736383442266
701,swap,8239.0,399,12,14,2,26,0.3618736383442266
702,swap,8239.0,399,12,14,2,26,0.3618736383442266
703,swap,8239.0,399,12,14,2,26,0.3618736383442266
704,swap,8239.0,399,12,14,2,26,0.3618736383442266
705,swap,8239.0,399,12,14,2,26,0.3618736383442266
706,mut_micro,8239.0,399,12,14,2,26,0.3618736383442266
707,swap,8239.0,399,12,14,2,26,0.3618736383442266
708,swap,8239.0,399,12,14,2,26,0.3618736383442266
709,swap,8239.0,399,12,14,2,26,0.3618736383442266
710,swap,8239.0,399,12,14,2,26,0.3618736383442266
711,swap,8239.0,399,12,14,2,26,0.3618736383442266
712,swap,8239.0,399,12,14,2,26,0.3618736383442266
713,swap,8239.0,399,12,14,2,26,0.3618736383442266
714,swap,8239.0,399,12,14,2,26,0.3618736383442266
715,swap,8239.0,399,12,14,2,26,0.3618736383442266
716,swap,8239.0,399,12,14,2,26,0.3618736383442266
717,swap,8239.0,399,12,14,2,26,0.3618736383442266
718,swap,8239.0,399,12,14,2,26,0.3618736383442266
719,swap,8237.0,397,12,14,2,26,0.3587864167749119
720,swap,8237.0,397,12,14,2,26,0.3587864167749119
721,swap,8237.0,397,12,14,2,26,0.3587864167749119
722,swap,8237.0,397,12,14,2,26,0.3587864167749119
723,swap,8237.0,397,12,14,2,26,0.3587864167749119
724,swap,8237.0,397,12,14,2,26,0.3587864167749119
725,swap,8237.0,397,12,14,2,26,0.3587864167749119
726,reassign,8235.0,395,11,15,2,26,0.3556149732620322
727,swap,8235.0,395,11,15,2,26,0.3556149732620322
728,swap,8235.0,395,11,15,2,26,0.3556149732620322
729,swap,8235.0,395,11,15,2,26,0.3556149732620322
730,swap,8235.0,395,11,15,2,26,0.3556149732620322
731,swap,8235.0,395,11,15,2,26,0.3556149732620322
732,swap,8235.0,395,11,15,2,26,0.3556149732620322
733,swap,8235.0,395,11,15,2,26,0.3556149732620322
734,swap,8235.0,395,11,15,2,26,0.3556149732620322
735,swap,8235.0,395,11,15,2,26,0.3556149732620322
736,swap,8235.0,395,11,15,2,26,0.3556149732620322
737,swap,8235.0,395,11,15,2,26,0.3556149732620322
738,swap,8235.0,395,11,15,2,26,0.3556149732620322
739,swap,8235.0,395,11,15,2,26,0.3556149732620322
740,swap,8229.0,389,11,15,2,26,0.3515233785822022
741,swap,8229.0,389,11,15,2,26,0.3515233785822022
742,swap,8229.0,389,11,15,2,26,0.3515233785822022
743,swap,8229.0,389,11,15,2,26,0.3515233785822022
744,swap,8229.0,389,11,15,2,26,0.3515233785822022
745,swap,8229.0,389,11,15,2,26,0.3515233785822022
746,swap,8229.0,389,11,15,2,26,0.3515233785822022
747,swap,8229.0,389,11,15,2,26,0.3515233785822022
748,swap,8229.0,389,11,15,2,26,0.3515233785822022
749,swap,8229.0,389,11,15,2,26,0.3515233785822022
750,swap,8229.0,389,11,15,2,26,0.3515233785822022
751,swap,8229.0,389,11,15,2,26,0.3515233785822022
752,reassign,8229.0,389,11,15,2,26,0.3515233785822022
753,swap,8229.0,389,11,15,2,26,0.3515233785822022
754,swap,8229.0,389,11,15,2,26,0.3515233785822022
755,swap,8229.0,389,11,15,2,26,0.3515233785822022
756,mut_micro,8229.0,389,11,15,2,26,0.3515233785822022
757,swap,8229.0,389,11,15,2,26,0.3515233785822022
758,swap,8229.0,389,11,15,2,26,0.3515233785822022
759,swap,8229.0,389,11,15,2,26,0.3515233785822022
760,swap,8229.0,389,11,15,2,26,0.3515233785822022
761,swap,8229.0,389,11,15,2,26,0.3515233785822022
762,reassign,8229.0,389,11,15,2,26,0.3515233785822022
763,swap,8229.0,389,11,15,2,26,0.3515233785822022
764,swap,8229.0,389,11,15,2,26,0.3515233785822022
765,swap,8229.0,389,11,15,2,26,0.3515233785822022
766,swap,8229.0,389,11,15,2,26,0.3515233785822022
767,swap,8229.0,389,11,15,2,26,0.3515233785822022
768,swap,8229.0,389,11,15,2,26,0.3515233785822022
769,swap,8229.0,389,11,15,2,26,0.3515233785822022
770,swap,8229.0,389,11,15,2,26,0.3515233785822022
771,swap,8229.0,389,11,15,2,26,0.3515233785822022
772,swap,8229.0,389,11,15,2,26,0.3515233785822022
773,mut_micro,8229.0,389,11,15,2,26,0.3515233785822022
774,swap,8229.0,389,11,15,2,26,0.3515233785822022
775,swap,8229.0,389,11,15,2,26,0.3515233785822022
776,swap,8229.0,389,11,15,2,26,0.3515233785822022
777,swap,8229.0,389,11,15,2,26,0.3515233785822022
778,swap,8229.0,389,11,15,2,26,0.3515233785822022
779,swap,8229.0,389,11,15,2,26,0.3515233785822022
780,swap,8229.0,389,11,15,2,26,0.3515233785822022
781,swap,8229.0,389,11,15,2,26,0.3515233785822022
782,swap,8229.0,389,11,15,2,26,0.3515233785822022
783,swap,8229.0,389,11,15,2,26,0.3515233785822022
784,swap,8229.0,389,11,15,2,26,0.3515233785822022
785,swap,8229.0,389,11,15,2,26,0.3515233785822022
786,swap,8229.0,389,11,15,2,26,0.3515233785822022
787,swap,8229.0,389,11,15,2,26,0.3515233785822022
788,swap,8229.0,389,11,15,2,26,0.3515233785822022
789,swap,8228.0,388,11,15,2,26,0.3522795621316011
790,swap,8228.0,388,11,15,2,26,0.3522795621316011
791,swap,8228.0,388,11,15,2,26,0.3522795621316011
792,swap,8228.0,388,11,15,2,26,0.3522795621316011
793,swap,8228.0,388,11,15,2,26,0.3522795621316011
794,swap,8228.0,388,11,15,2,26,0.3522795621316011
795,swap,8228.0,388,11,15,2,26,0.3522795621316011
796,swap,8228.0,388,11,15,2,26,0.3522795621316011
797,swap,8228.0,388,11,15,2,26,0.3522795621316011
798,reassign,8228.0,388,11,15,2,26,0.3522795621316011
799,swap,8228.0,388,11,15,2,26,0.3522795621316011
800,swap,8228.0,388,11,15,2,26,0.3522795621316011
801,reassign,8186.0,386,11,15,0,26,0.3489956958393113
802,swap,8186.0,386,11,15,0,26,0.3489956958393113
803,swap,8186.0,386,11,15,0,26,0.3489956958393113
804,swap,8186.0,386,11,15,0,26,0.3489956958393113
805,swap,7892.0,392,11,14,0,25,0.35647302399220554
806,swap,7892.0,392,11,14,0,25,0.35647302399220554
807,mut_micro,7892.0,392,11,14,0,25,0.35647302399220554
808,swap,7892.0,392,11,14,0,25,0.35647302399220554
809,swap,7892.0,392,11,14,0,25,0.35647302399220554
810,swap,7892.0,392,11,14,0,25,0.35647302399220554
811,swap,7892.0,392,11,14,0,25,0.35647302399220554
812,swap,7892.0,392,11,14,0,25,0.35647302399220554
813,swap,7892.0,392,11,14,0,25,0.35647302399220554
814,swap,7892.0,392,11,14,0,25,0.35647302399220554
815,swap,7892.0,392,11,14,0,25,0.35647302399220554
816,swap,7892.0,392,11,14,0,25,0.35647302399220554
817,swap,7892.0,392,11,14,0,25,0.35647302399220554
818,swap,7892.0,392,11,14,0,25,0.35647302399220554
819,swap,7892.0,392,11,14,0,25,0.35647302399220554
820,swap,7597.0,397,11,13,0,24,0.35977608709098785
821,swap,7597.0,397,11,13,0,24,0.35977608709098785
822,swap,7597.0,397,11,13,0,24,0.35977608709098785
823,swap,7597.0,397,11,13,0,24,0.35977608709098785
824,mut_micro,7597.0,397,11,13,0,24,0.35977608709098785
825,swap,7597.0,397,11,13,0,24,0.35977608709098785
826,swap,7597.0,397,11,13,0,24,0.35977608709098785
827,swap,7597.0,397,11,13,0,24,0.35977608709098785
828,swap,7597.0,397,11,13,0,24,0.35977608709098785
829,swap,7597.0,397,11,13,0,24,0.35977608709098785
830,swap,7593.0,393,11,13,0,24,0.3557204813389531
831,swap,7593.0,393,11,13,0,24,0.3557204813389531
832,swap,7593.0,393,11,13,0,24,0.3557204813389531
833,swap,7593.0,393,11,13,0,24,0.3557204813389531
834,swap,7593.0,393,11,13,0,24,0.3557204813389531
835,swap,7593.0,393,11,13,0,24,0.3557204813389531
836,swap,7593.0,393,11,13,0,24,0.3557204813389531
837,swap,7593.0,393,11,13,0,24,0.3557204813389531
838,swap,7593.0,393,11,13,0,24,0.3557204813389531
839,swap,7593.0,393,11,13,0,24,0.3557204813389531
840,swap,7593.0,393,11,13,0,24,0.3557204813389531
841,reassign,7593.0,393,11,13,0,24,0.3557204813389531
842,swap,7593.0,393,11,13,0,24,0.3557204813389531
843,swap,7593.0,393,11,13,0,24,0.3557204813389531
844,swap,7593.0,393,11,13,0,24,0.3557204813389531
845,swap,7593.0,393,11,13,0,24,0.3557204813389531
846,swap,7593.0,393,11,13,0,24,0.3557204813389531
847,swap,7593.0,393,11,13,0,24,0.3557204813389531
848,swap,7593.0,393,11,13,0,24,0.3557204813389531
849,swap,7593.0,393,11,13,0,24,0.3557204813389531
850,swap,7593.0,393,11,13,0,24,0.3557204813389531
851,swap,7593.0,393,11,13,0,24,0.3557204813389531
852,swap,7593.0,393,11,13,0,24,0.3557204813389531
853,swap,7593.0,393,11,13,0,24,0.3557204813389531
854,mut_micro,7593.0,393,11,13,0,24,0.3557204813389531
855,swap,7593.0,393,11,13,0,24,0.3557204813389531
856,swap,7593.0,393,11,13,0,24,0.3557204813389531
857,mut_micro,7593.0,393,11,13,0,24,0.3557204813389531
858,swap,7593.0,393,11,13,0,24,0.3557204813389531
859,swap,7593.0,393,11,13,0,24,0.3557204813389531
860,swap,7593.0,393,11,13,0,24,0.3557204813389531
861,swap,7593.0,393,11,13,0,24,0.3557204813389531
862,swap,7593.0,393,11,13,0,24,0.3557204813389531
863,swap,7593.0,393,11,13,0,24,0.3557204813389531
864,swap,7593.0,393,11,13,0,24,0.3557204813389531
865,swap,7593.0,393,11,13,0,24,0.3557204813389531
866,swap,7593.0,393,11,13,0,24,0.3557204813389531
867,swap,7593.0,393,11,13,0,24,0.3557204813389531
868,swap,7593.0,393,11,13,0,24,0.3557204813389531
869,swap,7593.0,393,11,13,0,24,0.3557204813389531
870,swap,7593.0,393,11,13,0,24,0.3557204813389531
871,swap,7593.0,393,11,13,0,24,0.3557204813389531
872,swap,7593.0,393,11,13,0,24,0.3557204813389531
873,swap,7593.0,393,11,13,0,24,0.3557204813389531
874,swap,7593.0,393,11,13,0,24,0.3557204813389531
875,swap,7593.0,393,11,13,0,24,0.3557204813389531
876,swap,7593.0,393,11,13,0,24,0.3557204813389531
877,swap,7593.0,393,11,13,0,24,0.3557204813389531
878,swap,7593.0,393,11,13,0,24,0.3557204813389531
879,swap,7592.0,392,11,13,0,24,0.35647302399220554
880,swap,7592.0,392,11,13,0,24,0.35647302399220554
881,swap,7592.0,392,11,13,0,24,0.35647302399220554
882,reassign,7592.0,392,11,13,0,24,0.35647302399220554
883,swap,7592.0,392,11,13,0,24,0.35647302399220554
884,swap,7592.0,392,11,13,0,24,0.35647302399220554
885,swap,7592.0,392,11,13,0,24,0.35647302399220554
886,reassign,7592.0,392,11,13,0,24,0.35647302399220554
887,swap,7592.0,392,11,13,0,24,0.35647302399220554
888,swap,7592.0,392,11,13,0,24,0.35647302399220554
889,swap,7592.0,392,11,13,0,24,0.35647302399220554
890,swap,7592.0,392,11,13,0,24,0.35647302399220554
891,swap,7592.0,392,11,13,0,24,0.35647302399220554
892,swap,7592.0,392,11,13,0,24,0.35647302399220554
893,swap,7592.0,392,11,13,0,24,0.35647302399220554
894,swap,7592.0,392,11,13,0,24,0.35647302399220554
895,swap,7592.0,392,11,13,0,24,0.35647302399220554
896,swap,7592.0,392,11,13,0,24,0.35647302399220554
897,swap,7592.0,392,11,13,0,24,0.35647302399220554
898,swap,7592.0,392,11,13,0,24,0.35647302399220554
899,swap,7592.0,392,11,13,0,24,0.35647302399220554
900,swap,7592.0,392,11,13,0,24,0.35647302399220554
901,swap,7592.0,392,11,13,0,24,0.35647302399220554
902,swap,7592.0,392,11,13,0,24,0.35647302399220554
903,swap,7297.0,397,11,12,0,23,0.35977608709098785
904,swap,7297.0,397,11,12,0,23,0.35977608709098785
905,swap,7297.0,397,11,12,0,23,0.35977608709098785
906,swap,7297.0,397,11,12,0,23,0.35977608709098785
907,swap,7297.0,397,11,12,0,23,0.35977608709098785
908,swap,7297.0,397,11,12,0,23,0.35977608709098785
909,swap,7297.0,397,11,12,0,23,0.35977608709098785
910,swap,7297.0,397,11,12,0,23,0.35977608709098785
911,swap,7297.0,397,11,12,0,23,0.35977608709098785
912,mut_micro,7297.0,397,11,12,0,23,0.35977608709098785
913,swap,7297.0,397,11,12,0,23,0.35977608709098785
914,swap,7297.0,397,11,12,0,23,0.35977608709098785
915,swap,7297.0,397,11,12,0,23,0.35977608709098785
916,swap,7297.0,397,11,12,0,23,0.35977608709098785
917,swap,7297.0,397,11,12,0,23,0.35977608709098785
918,swap,7297.0,397,11,12,0,23,0.35977608709098785
919,swap,7297.0,397,11,12,0,23,0.35977608709098785
920,swap,7297.0,397,11,12,0,23,0.35977608709098785
921,swap,7297.0,397,11,12,0,23,0.35977608709098785
922,swap,7297.0,397,11,12,0,23,0.35977608709098785
923,swap,7297.0,397,11,12,0,23,0.35977608709098785
924,swap,7297.0,397,11,12,0,23,0.35977608709098785
925,swap,7297.0,397,11,12,0,23,0.35977608709098785
926,swap,7297.0,397,11,12,0,23,0.35977608709098785
927,swap,7297.0,397,11,12,0,23,0.35977608709098785
928,swap,7297.0,397,11,12,0,23,0.35977608709098785
929,swap,7297.0,397,11,12,0,23,0.35977608709098785
930,swap,7297.0,397,11,12,0,23,0.35977608709098785
931,swap,7297.0,397,11,12,0,23,0.35977608709098785
932,swap,7297.0,397,11,12,0,23,0.35977608709098785
933,swap,7297.0,397,11,12,0,23,0.35977608709098785
934,swap,7297.0,397,11,12,0,23,0.35977608709098785
935,swap,7297.0,397,11,12,0,23,0.35977608709098785
936,swap,7297.0,397,11,12,0,23,0.35977608709098785
937,swap,7297.0,397,11,12,0,23,0.35977608709098785
938,swap,7297.0,397,11,12,0,23,0.35977608709098785
939,swap,7297.0,397,11,12,0,23,0.35977608709098785
940,swap,7297.0,397,11,12,0,23,0.35977608709098785
941,swap,7297.0,397,11,12,0,23,0.35977608709098785
942,swap,7297.0,397,11,12,0,23,0.35977608709098785
943,swap,7297.0,397,11,12,0,23,0.35977608709098785
944,swap,7297.0,397,11,12,0,23,0.35977608709098785
945,swap,7297.0,397,11,12,0,23,0.35977608709098785
946,swap,7297.0,397,11,12,0,23,0.35977608709098785
947,swap,7297.0,397,11,12,0,23,0.35977608709098785
948,swap,7297.0,397,11,12,0,23,0.35977608709098785
949,swap,7297.0,397,11,12,0,23,0.35977608709098785
950,swap,7297.0,397,11,12,0,23,0.35977608709098785
951,swap,7297.0,397,11,12,0,23,0.35977608709098785
952,swap,7296.0,396,11,12,0,23,0.3590455049944506
953,swap,7296.0,396,11,12,0,23,0.3590455049944506
954,swap,7296.0,396,11,12,0,23,0.3590455049944506
955,swap,7296.0,396,11,12,0,23,0.3590455049944506
956,swap,7296.0,396,11,12,0,23,0.3590455049944506
957,swap,7296.0,396,11,12,0,23,0.3590455049944506
958,swap,7296.0,396,11,12,0,23,0.3590455049944506
959,reassign,7293.0,393,10,13,0,23,0.3551096451041477
960,swap,7293.0,393,10,13,0,23,0.3551096451041477
961,swap,7293.0,393,10,13,0,23,0.3551096451041477
962,swap,7293.0,393,10,13,0,23,0.3551096451041477
963,swap,7293.0,393,10,13,0,23,0.3551096451041477
964,swap,7293.0,393,10,13,0,23,0.3551096451041477
965,swap,7293.0,393,10,13,0,23,0.3551096451041477
966,swap,7293.0,393,10,13,0,23,0.3551096451041477
967,swap,7293.0,393,10,13,0,23,0.3551096451041477
968,swap,7293.0,393,10,13,0,23,0.3551096451041477
969,swap,7293.0,393,10,13,0,23,0.3551096451041477
970,swap,7293.0,393,10,13,0,23,0.3551096451041477
971,swap,7293.0,393,10,13,0,23,0.3551096451041477
972,swap,7293.0,393,10,13,0,23,0.3551096451041477
973,swap,7293.0,393,10,13,0,23,0.3551096451041477
974,swap,7293.0,393,10,13,0,23,0.3551096451041477
975,swap,7293.0,393,10,13,0,23,0.3551096451041477
976,swap,7293.0,393,10,13,0,23,0.3551096451041477
977,swap,7293.0,393,10,13,0,23,0.3551096451041477
978,swap,7293.0,393,10,13,0,23,0.3551096451041477
979,swap,7293.0,393,10,13,0,23,0.3551096451041477
980,swap,7293.0,393,10,13,0,23,0.3551096451041477
981,swap,7293.0,393,10,13,0,23,0.3551096451041477
982,swap,7293.0,393,10,13,0,23,0.3551096451041477
983,swap,7293.0,393,10,13,0,23,0.3551096451041477
984,swap,7293.0,393,10,13,0,23,0.3551096451041477
985,swap,7293.0,393,10,13,0,23,0.3551096451041477
986,swap,7293.0,393,10,13,0,23,0.3551096451041477
987,swap,7293.0,393,10,13,0,23,0.3551096451041477
988,swap,7293.0,393,10,13,0,23,0.3551096451041477
989,swap,7293.0,393,10,13,0,23,0.3551096451041477
990,reassign,7293.0,393,10,13,0,23,0.3551096451041477
991,swap,7293.0,393,10,13,0,23,0.3551096451041477
992,swap,7293.0,393,10,13,0,23,0.3551096451041477
993,swap,7293.0,393,10,13,0,23,0.3551096451041477
994,swap,7293.0,393,10,13,0,23,0.3551096451041477
995,swap,7293.0,393,10,13,0,23,0.3551096451041477
996,swap,7293.0,393,10,13,0,23,0.3551096451041477
997,swap,7293.0,393,10,13,0,23,0.3551096451041477
998,swap,7293.0,393,10,13,0,23,0.3551096451041477
999,swap,7293.0,393,10,13,0,23,0.3551096451041477
1000,swap,7293.0,393,10,13,0,23,0.3551096451041477
