iter,op,fitness_score,pref_penalty,capacity_viol,elig_viol,under_cap,total_violations,gini
1,swap,26275.0,335,24,62,7,86,0.2543069998447929
2,reassign,26275.0,335,24,62,7,86,0.2543069998447929
3,mut_micro,25974.0,334,24,61,7,85,0.25438596491228066
4,mut_micro,25974.0,334,24,61,7,85,0.25438596491228066
5,swap,25974.0,334,24,61,7,85,0.25438596491228066
6,mut_micro,25678.0,338,25,59,7,84,0.25610137672090144
7,mut_micro,25677.0,337,26,58,7,84,0.25440786394133225
8,mut_micro,25677.0,337,26,58,7,84,0.25440786394133225
9,mut_micro,25677.0,337,26,58,7,84,0.25440786394133225
10,mut_micro,25677.0,337,26,58,7,84,0.25440786394133225
11,mut_micro,25674.0,334,26,58,7,84,0.25438596491228066
12,mut_micro,25674.0,334,26,58,7,84,0.25438596491228066
13,mut_micro,25674.0,334,26,58,7,84,0.25438596491228066
14,mut_micro,25050.0,330,24,58,6,82,0.2525020424836602
15,mut_micro,24133.0,333,23,56,5,79,0.25266327003242267
16,mut_micro,24133.0,333,23,56,5,79,0.25266327003242267
17,reassign,24133.0,333,23,56,5,79,0.25266327003242267
18,mut_micro,24133.0,333,23,56,5,79,0.25266327003242267
19,mut_micro,23832.0,332,23,55,5,78,0.2508982650651882
20,mut_micro,23832.0,332,23,55,5,78,0.2508982650651882
21,mut_micro,23832.0,332,23,55,5,78,0.2508982650651882
22,mut_micro,23832.0,332,23,55,5,78,0.2508982650651882
23,mut_micro,23832.0,332,23,55,5,78,0.2508982650651882
24,mut_micro,23832.0,332,23,55,5,78,0.2508982650651882
25,mut_micro,23210.0,330,22,54,4,76,0.24637459150326793
26,mut_micro,23210.0,330,22,54,4,76,0.24637459150326793
27,mut_micro,23210.0,330,22,54,4,76,0.24637459150326793
28,mut_micro,22894.0,334,20,55,3,75,0.24814241486068112
29,mut_micro,22894.0,334,20,55,3,75,0.24814241486068112
30,mut_micro,22894.0,334,20,55,3,75,0.24814241486068112
31,mut_micro,22894.0,334,20,55,3,75,0.24814241486068112
32,mut_micro,22894.0,334,20,55,3,75,0.24814241486068112
33,mut_micro,22597.0,337,20,54,3,74,0.2479585998855774
34,mut_micro,21681.0,341,18,53,2,71,0.2494086106292383
35,mut_micro,21378.0,338,18,52,2,70,0.24692323738005856
36,mut_micro,21062.0,342,18,51,1,69,0.24831330381614997
37,mut_micro,21062.0,342,18,51,1,69,0.24831330381614997
38,mut_micro,21062.0,342,18,51,1,69,0.24831330381614997
39,mut_micro,21062.0,342,18,51,1,69,0.24831330381614997
40,mut_micro,21062.0,342,18,51,1,69,0.24831330381614997
41,mut_micro,21062.0,342,18,51,1,69,0.24831330381614997
42,swap,21062.0,342,18,51,1,69,0.24831330381614997
43,mut_micro,21061.0,341,18,51,1,69,0.2494086106292383
44,mut_micro,21059.0,339,18,51,1,69,0.24870588235294128
45,mut_micro,20760.0,340,18,50,1,68,0.2476145538429275
46,mut_micro,20760.0,340,18,50,1,68,0.2476145538429275
47,mut_micro,20760.0,340,18,50,1,68,0.2476145538429275
48,mut_micro,20756.0,336,18,50,1,68,0.24224504616661494
49,mut_micro,20756.0,336,18,50,1,68,0.24224504616661494
50,mut_micro,20756.0,336,18,50,1,68,0.24224504616661494
51,swap,20460.0,340,18,49,1,67,0.2476145538429275
52,swap,20164.0,344,18,48,1,66,0.2558558558558559
53,mut_micro,20164.0,344,18,48,1,66,0.2558558558558559
54,swap,20164.0,344,18,48,1,66,0.2558558558558559
55,swap,20164.0,344,18,48,1,66,0.2558558558558559
56,swap,20164.0,344,18,48,1,66,0.2558558558558559
57,swap,20164.0,344,18,48,1,66,0.2558558558558559
58,swap,19869.0,349,18,47,1,65,0.2599247918345421
59,swap,19869.0,349,18,47,1,65,0.2599247918345421
60,swap,19574.0,354,18,46,1,64,0.26966230936819174
61,swap,19574.0,354,18,46,1,64,0.26966230936819174
62,swap,19574.0,354,18,46,1,64,0.26966230936819174
63,swap,19574.0,354,18,46,1,64,0.26966230936819174
64,swap,18981.0,361,18,44,1,62,0.274037660389935
65,swap,18689.0,369,18,43,1,61,0.28266552998010797
66,swap,18689.0,369,18,43,1,61,0.28266552998010797
67,swap,18689.0,369,18,43,1,61,0.28266552998010797
68,swap,18689.0,369,18,43,1,61,0.28266552998010797
69,mut_micro,18689.0,369,18,43,1,61,0.28266552998010797
70,swap,18689.0,369,18,43,1,61,0.28266552998010797
71,swap,18689.0,369,18,43,1,61,0.28266552998010797
72,swap,18394.0,374,18,42,1,60,0.29186851211072673
73,swap,18394.0,374,18,42,1,60,0.29186851211072673
74,swap,18394.0,374,18,42,1,60,0.29186851211072673
75,swap,18392.0,372,18,42,1,60,0.28958834995986715
76,swap,18392.0,372,18,42,1,60,0.28958834995986715
77,swap,18392.0,372,18,42,1,60,0.28958834995986715
78,swap,18392.0,372,18,42,1,60,0.28958834995986715
79,swap,18392.0,372,18,42,1,60,0.28958834995986715
80,swap,18392.0,372,18,42,1,60,0.28958834995986715
81,swap,18392.0,372,18,42,1,60,0.28958834995986715
82,swap,18392.0,372,18,42,1,60,0.28958834995986715
83,swap,18098.0,378,18,41,1,59,0.299311391223156
84,reassign,18098.0,378,18,41,1,59,0.299311391223156
85,swap,18098.0,378,18,41,1,59,0.299311391223156
86,swap,18098.0,378,18,41,1,59,0.299311391223156
87,swap,18096.0,376,18,41,1,59,0.29707622694048047
88,swap,18096.0,376,18,41,1,59,0.29707622694048047
89,swap,17799.0,379,18,40,1,58,0.30368744512730467
90,swap,17799.0,379,18,40,1,58,0.30368744512730467
91,swap,17799.0,379,18,40,1,58,0.30368744512730467
92,swap,17799.0,379,18,40,1,58,0.30368744512730467
93,swap,17799.0,379,18,40,1,58,0.30368744512730467
94,swap,17799.0,379,18,40,1,58,0.30368744512730467
95,swap,17799.0,379,18,40,1,58,0.30368744512730467
96,swap,17799.0,379,18,40,1,58,0.30368744512730467
97,swap,17799.0,379,18,40,1,58,0.30368744512730467
98,swap,17799.0,379,18,40,1,58,0.30368744512730467
99,swap,17799.0,379,18,40,1,58,0.30368744512730467
100,swap,17799.0,379,18,40,1,58,0.30368744512730467
101,swap,17799.0,379,18,40,1,58,0.30368744512730467
102,swap,17799.0,379,18,40,1,58,0.30368744512730467
103,swap,17799.0,379,18,40,1,58,0.30368744512730467
104,swap,17799.0,379,18,40,1,58,0.30368744512730467
105,swap,17799.0,379,18,40,1,58,0.30368744512730467
106,swap,17799.0,379,18,40,1,58,0.30368744512730467
107,swap,17799.0,379,18,40,1,58,0.30368744512730467
108,swap,17799.0,379,18,40,1,58,0.30368744512730467
109,swap,17799.0,379,18,40,1,58,0.30368744512730467
110,reassign,17500.0,380,17,40,1,57,0.3061524010801926
111,reassign,17500.0,380,17,40,1,57,0.3061524010801926
112,reassign,17497.0,377,17,40,1,57,0.3013614941525572
113,reassign,17497.0,377,17,40,1,57,0.3013614941525572
114,swap,17497.0,377,17,40,1,57,0.3013614941525572
115,swap,17497.0,377,17,40,1,57,0.3013614941525572
116,reassign,17497.0,377,17,40,1,57,0.3013614941525572
117,swap,17201.0,381,17,39,1,56,0.3085732791615146
118,swap,17201.0,381,17,39,1,56,0.3085732791615146
119,swap,17201.0,381,17,39,1,56,0.3085732791615146
120,swap,17201.0,381,17,39,1,56,0.3085732791615146
121,swap,16906.0,386,17,38,1,55,0.31533955045432815
122,swap,16906.0,386,17,38,1,55,0.31533955045432815
123,swap,16906.0,386,17,38,1,55,0.31533955045432815
124,swap,16906.0,386,17,38,1,55,0.31533955045432815
125,swap,16906.0,386,17,38,1,55,0.31533955045432815
126,reassign,16906.0,386,17,38,1,55,0.31533955045432815
127,swap,16906.0,386,17,38,1,55,0.31533955045432815
128,swap,16906.0,386,17,38,1,55,0.31533955045432815
129,swap,16906.0,386,17,38,1,55,0.31533955045432815
130,swap,16903.0,383,17,38,1,55,0.31606539896925545
131,swap,16903.0,383,17,38,1,55,0.31606539896925545
132,reassign,16903.0,383,17,38,1,55,0.31606539896925545
133,swap,16903.0,383,17,38,1,55,0.31606539896925545
134,swap,16903.0,383,17,38,1,55,0.31606539896925545
135,swap,16903.0,383,17,38,1,55,0.31606539896925545
136,mut_micro,16624.0,384,17,37,2,54,0.3158051099227569
137,swap,16624.0,384,17,37,2,54,0.3158051099227569
138,swap,16624.0,384,17,37,2,54,0.3158051099227569
139,swap,16624.0,384,17,37,2,54,0.3158051099227569
140,swap,16624.0,384,17,37,2,54,0.3158051099227569
141,swap,16624.0,384,17,37,2,54,0.3158051099227569
142,swap,16624.0,384,17,37,2,54,0.3158051099227569
143,swap,16624.0,384,17,37,2,54,0.3158051099227569
144,swap,16624.0,384,17,37,2,54,0.3158051099227569
145,mut_micro,16624.0,384,17,37,2,54,0.3158051099227569
146,swap,16328.0,388,17,36,2,53,0.3201010465535907
147,swap,16328.0,388,17,36,2,53,0.3201010465535907
148,swap,16328.0,388,17,36,2,53,0.3201010465535907
149,swap,16031.0,391,17,35,2,52,0.3261397438232258
150,swap,16031.0,391,17,35,2,52,0.3261397438232258
151,swap,16031.0,391,17,35,2,52,0.3261397438232258
152,swap,16031.0,391,17,35,2,52,0.3261397438232258
153,swap,16031.0,391,17,35,2,52,0.3261397438232258
154,swap,16031.0,391,17,35,2,52,0.3261397438232258
155,swap,16031.0,391,17,35,2,52,0.3261397438232258
156,swap,16031.0,391,17,35,2,52,0.3261397438232258
157,swap,16031.0,391,17,35,2,52,0.3261397438232258
158,swap,16031.0,391,17,35,2,52,0.3261397438232258
159,swap,16031.0,391,17,35,2,52,0.3261397438232258
160,swap,16031.0,391,17,35,2,52,0.3261397438232258
161,swap,16031.0,391,17,35,2,52,0.3261397438232258
162,swap,16031.0,391,17,35,2,52,0.3261397438232258
163,swap,16031.0,391,17,35,2,52,0.3261397438232258
164,swap,16031.0,391,17,35,2,52,0.3261397438232258
165,swap,16031.0,391,17,35,2,52,0.3261397438232258
166,swap,16031.0,391,17,35,2,52,0.3261397438232258
167,swap,16031.0,391,17,35,2,52,0.3261397438232258
168,swap,16031.0,391,17,35,2,52,0.3261397438232258
169,swap,16031.0,391,17,35,2,52,0.3261397438232258
170,swap,16031.0,391,17,35,2,52,0.3261397438232258
171,swap,16031.0,391,17,35,2,52,0.3261397438232258
172,swap,15734.0,394,17,34,2,51,0.33057598039215674
173,swap,15734.0,394,17,34,2,51,0.33057598039215674
174,swap,15734.0,394,17,34,2,51,0.33057598039215674
175,swap,15734.0,394,17,34,2,51,0.33057598039215674
176,swap,15734.0,394,17,34,2,51,0.33057598039215674
177,swap,15734.0,394,17,34,2,51,0.33057598039215674
178,swap,15734.0,394,17,34,2,51,0.33057598039215674
179,swap,15734.0,394,17,34,2,51,0.33057598039215674
180,swap,15734.0,394,17,34,2,51,0.33057598039215674
181,swap,15734.0,394,17,34,2,51,0.33057598039215674
182,mut_micro,15734.0,394,17,34,2,51,0.33057598039215674
183,reassign,15434.0,394,16,34,2,50,0.33057598039215674
184,mut_micro,15434.0,394,16,34,2,50,0.33057598039215674
185,swap,15138.0,398,16,33,2,49,0.3345743360635394
186,swap,15138.0,398,16,33,2,49,0.3345743360635394
187,swap,15138.0,398,16,33,2,49,0.3345743360635394
188,swap,15138.0,398,16,33,2,49,0.3345743360635394
189,swap,15138.0,398,16,33,2,49,0.3345743360635394
190,swap,14843.0,403,16,32,2,48,0.3405522980896539
191,swap,14843.0,403,16,32,2,48,0.3405522980896539
192,swap,14843.0,403,16,32,2,48,0.3405522980896539
193,swap,14843.0,403,16,32,2,48,0.3405522980896539
194,mut_micro,13942.0,402,15,30,2,45,0.33986928104575154
195,mut_micro,13942.0,402,15,30,2,45,0.33986928104575154
196,mut_micro,13942.0,402,15,30,2,45,0.33986928104575154
197,mut_micro,13618.0,398,14,30,1,44,0.33600148920327627
198,mut_micro,13618.0,398,14,30,1,44,0.33600148920327627
199,swap,13318.0,398,14,29,1,43,0.33600148920327627
200,swap,13318.0,398,14,29,1,43,0.33600148920327627
201,swap,13318.0,398,14,29,1,43,0.33600148920327627
202,swap,13318.0,398,14,29,1,43,0.33600148920327627
203,swap,13318.0,398,14,29,1,43,0.33600148920327627
204,swap,13317.0,397,14,29,1,43,0.3363332714789387
205,swap,13317.0,397,14,29,1,43,0.3363332714789387
206,swap,13317.0,397,14,29,1,43,0.3363332714789387
207,swap,13317.0,397,14,29,1,43,0.3363332714789387
208,mut_micro,12718.0,398,12,29,1,41,0.3377388930255647
209,mut_micro,12717.0,397,11,30,1,41,0.3355910187418817
210,mut_micro,12717.0,397,11,30,1,41,0.3355910187418817
211,mut_micro,12717.0,397,11,30,1,41,0.3355910187418817
212,mut_micro,12717.0,397,11,30,1,41,0.3355910187418817
213,swap,12717.0,397,11,30,1,41,0.3355910187418817
214,swap,12717.0,397,11,30,1,41,0.3355910187418817
215,swap,12717.0,397,11,30,1,41,0.3355910187418817
216,swap,12717.0,397,11,30,1,41,0.3355910187418817
217,swap,12717.0,397,11,30,1,41,0.3355910187418817
218,swap,12717.0,397,11,30,1,41,0.3355910187418817
219,swap,12717.0,397,11,30,1,41,0.3355910187418817
220,swap,12717.0,397,11,30,1,41,0.3355910187418817
221,swap,12717.0,397,11,30,1,41,0.3355910187418817
222,swap,12717.0,397,11,30,1,41,0.3355910187418817
223,swap,12717.0,397,11,30,1,41,0.3355910187418817
224,swap,12717.0,397,11,30,1,41,0.3355910187418817
225,swap,12717.0,397,11,30,1,41,0.3355910187418817
226,mut_micro,12717.0,397,11,30,1,41,0.3355910187418817
227,swap,12717.0,397,11,30,1,41,0.3355910187418817
228,swap,12717.0,397,11,30,1,41,0.3355910187418817
229,swap,12717.0,397,11,30,1,41,0.3355910187418817
230,swap,12717.0,397,11,30,1,41,0.3355910187418817
231,swap,12717.0,397,11,30,1,41,0.3355910187418817
232,reassign,12717.0,397,11,30,1,41,0.3355910187418817
233,swap,12717.0,397,11,30,1,41,0.3355910187418817
234,reassign,12717.0,397,11,30,1,41,0.3355910187418817
235,swap,12717.0,397,11,30,1,41,0.3355910187418817
236,swap,12717.0,397,11,30,1,41,0.3355910187418817
237,swap,12717.0,397,11,30,1,41,0.3355910187418817
238,swap,12715.0,395,11,30,1,41,0.3320118015858382
239,swap,12715.0,395,11,30,1,41,0.3320118015858382
240,swap,12715.0,395,11,30,1,41,0.3320118015858382
241,swap,12715.0,395,11,30,1,41,0.3320118015858382
242,swap,12715.0,395,11,30,1,41,0.3320118015858382
243,swap,12715.0,395,11,30,1,41,0.3320118015858382
244,swap,12715.0,395,11,30,1,41,0.3320118015858382
245,swap,12715.0,395,11,30,1,41,0.3320118015858382
246,swap,12715.0,395,11,30,1,41,0.3320118015858382
247,swap,12715.0,395,11,30,1,41,0.3320118015858382
248,swap,12715.0,395,11,30,1,41,0.3320118015858382
249,swap,12715.0,395,11,30,1,41,0.3320118015858382
250,swap,12715.0,395,11,30,1,41,0.3320118015858382
251,swap,12715.0,395,11,30,1,41,0.3320118015858382
252,swap,12715.0,395,11,30,1,41,0.3320118015858382
253,swap,12715.0,395,11,30,1,41,0.3320118015858382
254,swap,12712.0,392,11,30,1,41,0.33010595542564847
255,swap,12712.0,392,11,30,1,41,0.33010595542564847
256,mut_micro,12712.0,392,11,30,1,41,0.33010595542564847
257,swap,12712.0,392,11,30,1,41,0.33010595542564847
258,swap,12712.0,392,11,30,1,41,0.33010595542564847
259,swap,12712.0,392,11,30,1,41,0.33010595542564847
260,swap,12712.0,392,11,30,1,41,0.33010595542564847
261,swap,12712.0,392,11,30,1,41,0.33010595542564847
262,reassign,12712.0,392,11,30,1,41,0.33010595542564847
263,swap,12712.0,392,11,30,1,41,0.33010595542564847
264,swap,12712.0,392,11,30,1,41,0.33010595542564847
265,swap,12712.0,392,11,30,1,41,0.33010595542564847
266,swap,12712.0,392,11,30,1,41,0.33010595542564847
267,swap,12712.0,392,11,30,1,41,0.33010595542564847
268,swap,12708.0,388,11,30,1,41,0.3277998315890774
269,swap,12708.0,388,11,30,1,41,0.3277998315890774
270,swap,12708.0,388,11,30,1,41,0.3277998315890774
271,swap,12708.0,388,11,30,1,41,0.3277998315890774
272,swap,12708.0,388,11,30,1,41,0.3277998315890774
273,swap,12405.0,385,11,29,1,40,0.32823767804994336
274,swap,12405.0,385,11,29,1,40,0.32823767804994336
275,swap,12405.0,385,11,29,1,40,0.32823767804994336
276,swap,12405.0,385,11,29,1,40,0.32823767804994336
277,swap,12405.0,385,11,29,1,40,0.32823767804994336
278,swap,12405.0,385,11,29,1,40,0.32823767804994336
279,swap,12405.0,385,11,29,1,40,0.32823767804994336
280,swap,12405.0,385,11,29,1,40,0.32823767804994336
281,swap,12405.0,385,11,29,1,40,0.32823767804994336
282,swap,12405.0,385,11,29,1,40,0.32823767804994336
283,swap,12405.0,385,11,29,1,40,0.32823767804994336
284,swap,12405.0,385,11,29,1,40,0.32823767804994336
285,swap,12405.0,385,11,29,1,40,0.32823767804994336
286,swap,12405.0,385,11,29,1,40,0.32823767804994336
287,swap,12405.0,385,11,29,1,40,0.32823767804994336
288,swap,12405.0,385,11,29,1,40,0.32823767804994336
289,swap,12405.0,385,11,29,1,40,0.32823767804994336
290,reassign,12405.0,385,11,29,1,40,0.32823767804994336
291,swap,12404.0,384,11,29,1,40,0.3267379679144385
292,swap,12404.0,384,11,29,1,40,0.3267379679144385
293,swap,12404.0,384,11,29,1,40,0.3267379679144385
294,swap,12404.0,384,11,29,1,40,0.3267379679144385
295,swap,12404.0,384,11,29,1,40,0.3267379679144385
296,swap,12402.0,382,11,29,1,40,0.32660051972596266
297,swap,12402.0,382,11,29,1,40,0.32660051972596266
298,swap,12402.0,382,11,29,1,40,0.32660051972596266
299,swap,12402.0,382,11,29,1,40,0.32660051972596266
300,swap,12402.0,382,11,29,1,40,0.32660051972596266
301,swap,12402.0,382,11,29,1,40,0.32660051972596266
302,swap,12402.0,382,11,29,1,40,0.32660051972596266
303,swap,12402.0,382,11,29,1,40,0.32660051972596266
304,swap,12402.0,382,11,29,1,40,0.32660051972596266
305,swap,12399.0,379,11,29,1,40,0.32101258413813294
306,swap,12399.0,379,11,29,1,40,0.32101258413813294
307,swap,12399.0,379,11,29,1,40,0.32101258413813294
308,swap,12399.0,379,11,29,1,40,0.32101258413813294
309,swap,12399.0,379,11,29,1,40,0.32101258413813294
310,swap,12399.0,379,11,29,1,40,0.32101258413813294
311,swap,12399.0,379,11,29,1,40,0.32101258413813294
312,swap,12399.0,379,11,29,1,40,0.32101258413813294
313,swap,12399.0,379,11,29,1,40,0.32101258413813294
314,swap,12399.0,379,11,29,1,40,0.32101258413813294
315,swap,12399.0,379,11,29,1,40,0.32101258413813294
316,swap,12399.0,379,11,29,1,40,0.32101258413813294
317,swap,12399.0,379,11,29,1,40,0.32101258413813294
318,swap,12399.0,379,11,29,1,40,0.32101258413813294
319,swap,12399.0,379,11,29,1,40,0.32101258413813294
320,swap,12399.0,379,11,29,1,40,0.32101258413813294
321,swap,12399.0,379,11,29,1,40,0.32101258413813294
322,swap,12399.0,379,11,29,1,40,0.32101258413813294
323,swap,12399.0,379,11,29,1,40,0.32101258413813294
324,swap,12399.0,379,11,29,1,40,0.32101258413813294
325,swap,12399.0,379,11,29,1,40,0.32101258413813294
326,swap,12399.0,379,11,29,1,40,0.32101258413813294
327,swap,12399.0,379,11,29,1,40,0.32101258413813294
328,swap,12399.0,379,11,29,1,40,0.32101258413813294
329,swap,12399.0,379,11,29,1,40,0.32101258413813294
330,swap,11805.0,385,11,27,1,38,0.3265093271351092
331,swap,11805.0,385,11,27,1,38,0.3265093271351092
332,swap,11805.0,385,11,27,1,38,0.3265093271351092
333,swap,11805.0,385,11,27,1,38,0.3265093271351092
334,swap,11805.0,385,11,27,1,38,0.3265093271351092
335,swap,11805.0,385,11,27,1,38,0.3265093271351092
336,swap,11805.0,385,11,27,1,38,0.3265093271351092
337,swap,11805.0,385,11,27,1,38,0.3265093271351092
338,swap,11805.0,385,11,27,1,38,0.3265093271351092
339,swap,11805.0,385,11,27,1,38,0.3265093271351092
340,swap,11805.0,385,11,27,1,38,0.3265093271351092
341,swap,11805.0,385,11,27,1,38,0.3265093271351092
342,swap,11805.0,385,11,27,1,38,0.3265093271351092
343,swap,11805.0,385,11,27,1,38,0.3265093271351092
344,swap,11805.0,385,11,27,1,38,0.3265093271351092
345,swap,11805.0,385,11,27,1,38,0.3265093271351092
346,swap,11805.0,385,11,27,1,38,0.3265093271351092
347,swap,11805.0,385,11,27,1,38,0.3265093271351092
348,swap,11805.0,385,11,27,1,38,0.3265093271351092
349,swap,11803.0,383,11,27,1,38,0.32767608553995614
350,swap,11803.0,383,11,27,1,38,0.32767608553995614
351,swap,11803.0,383,11,27,1,38,0.32767608553995614
352,swap,11803.0,383,11,27,1,38,0.32767608553995614
353,swap,11803.0,383,11,27,1,38,0.32767608553995614
354,swap,11803.0,383,11,27,1,38,0.32767608553995614
355,swap,11803.0,383,11,27,1,38,0.32767608553995614
356,swap,11803.0,383,11,27,1,38,0.32767608553995614
357,swap,11803.0,383,11,27,1,38,0.32767608553995614
358,swap,11511.0,391,11,26,1,37,0.33536696412311046
359,swap,11508.0,388,11,26,1,37,0.3356790568988332
360,swap,11508.0,388,11,26,1,37,0.3356790568988332
361,swap,11508.0,388,11,26,1,37,0.3356790568988332
362,swap,11508.0,388,11,26,1,37,0.3356790568988332
363,swap,11508.0,388,11,26,1,37,0.3356790568988332
364,swap,11508.0,388,11,26,1,37,0.3356790568988332
365,swap,11508.0,388,11,26,1,37,0.3356790568988332
366,swap,11508.0,388,11,26,1,37,0.3356790568988332
367,swap,11507.0,387,11,26,1,37,0.3356419020207473
368,swap,11505.0,385,11,26,1,37,0.33211156803146785
369,swap,11505.0,385,11,26,1,37,0.33211156803146785
370,swap,11505.0,385,11,26,1,37,0.33211156803146785
371,swap,11505.0,385,11,26,1,37,0.33211156803146785
372,swap,11505.0,385,11,26,1,37,0.33211156803146785
373,swap,11212.0,392,11,25,1,36,0.3388746803069053
374,swap,11212.0,392,11,25,1,36,0.3388746803069053
375,swap,11211.0,391,11,25,1,36,0.3373702422145328
376,swap,11211.0,391,11,25,1,36,0.3373702422145328
377,swap,11211.0,391,11,25,1,36,0.3373702422145328
378,swap,11211.0,391,11,25,1,36,0.3373702422145328
379,swap,11211.0,391,11,25,1,36,0.3373702422145328
380,swap,11211.0,391,11,25,1,36,0.3373702422145328
381,swap,11211.0,391,11,25,1,36,0.3373702422145328
382,swap,11211.0,391,11,25,1,36,0.3373702422145328
383,swap,11211.0,391,11,25,1,36,0.3373702422145328
384,swap,11211.0,391,11,25,1,36,0.3373702422145328
385,swap,11211.0,391,11,25,1,36,0.3373702422145328
386,swap,11211.0,391,11,25,1,36,0.3373702422145328
387,swap,11211.0,391,11,25,1,36,0.3373702422145328
388,swap,11211.0,391,11,25,1,36,0.3373702422145328
389,swap,11211.0,391,11,25,1,36,0.3373702422145328
390,swap,11211.0,391,11,25,1,36,0.3373702422145328
391,swap,11211.0,391,11,25,1,36,0.3373702422145328
392,swap,11211.0,391,11,25,1,36,0.3373702422145328
393,reassign,10909.0,389,9,26,1,35,0.33843137254901956
394,swap,10909.0,389,9,26,1,35,0.33843137254901956
395,swap,10909.0,389,9,26,1,35,0.33843137254901956
396,swap,10607.0,387,9,25,1,34,0.3349223481441506
397,swap,10607.0,387,9,25,1,34,0.3349223481441506
398,swap,10312.0,392,9,24,1,33,0.33997077091706246
399,reassign,10312.0,392,9,24,1,33,0.33997077091706246
400,swap,10312.0,392,9,24,1,33,0.33997077091706246
401,swap,10312.0,392,9,24,1,33,0.33997077091706246
402,swap,10312.0,392,9,24,1,33,0.33997077091706246
403,swap,10312.0,392,9,24,1,33,0.33997077091706246
404,swap,10312.0,392,9,24,1,33,0.33997077091706246
405,mut_micro,10312.0,392,9,24,1,33,0.33997077091706246
406,swap,10312.0,392,9,24,1,33,0.33997077091706246
407,swap,10312.0,392,9,24,1,33,0.33997077091706246
408,swap,10312.0,392,9,24,1,33,0.33997077091706246
409,swap,10312.0,392,9,24,1,33,0.33997077091706246
410,swap,10312.0,392,9,24,1,33,0.33997077091706246
411,swap,10312.0,392,9,24,1,33,0.33997077091706246
412,swap,10312.0,392,9,24,1,33,0.33997077091706246
413,swap,10312.0,392,9,24,1,33,0.33997077091706246
414,mut_micro,10312.0,392,9,24,1,33,0.33997077091706246
415,swap,10312.0,392,9,24,1,33,0.33997077091706246
416,swap,10312.0,392,9,24,1,33,0.33997077091706246
417,swap,10312.0,392,9,24,1,33,0.33997077091706246
418,swap,10312.0,392,9,24,1,33,0.33997077091706246
419,swap,10312.0,392,9,24,1,33,0.33997077091706246
420,swap,10312.0,392,9,24,1,33,0.33997077091706246
421,swap,10312.0,392,9,24,1,33,0.33997077091706246
422,reassign,10312.0,392,9,24,1,33,0.33997077091706246
423,swap,10312.0,392,9,24,1,33,0.33997077091706246
424,swap,10312.0,392,9,24,1,33,0.33997077091706246
425,swap,10312.0,392,9,24,1,33,0.33997077091706246
426,swap,10309.0,389,9,24,1,33,0.3357164404223227
427,reassign,10309.0,389,9,24,1,33,0.3357164404223227
428,swap,10309.0,389,9,24,1,33,0.3357164404223227
429,mut_micro,10309.0,389,9,24,1,33,0.3357164404223227
430,swap,10309.0,389,9,24,1,33,0.3357164404223227
431,swap,10309.0,389,9,24,1,33,0.3357164404223227
432,swap,10309.0,389,9,24,1,33,0.3357164404223227
433,swap,10309.0,389,9,24,1,33,0.3357164404223227
434,swap,10308.0,388,9,24,1,33,0.3367616985444484
435,swap,10308.0,388,9,24,1,33,0.3367616985444484
436,swap,10308.0,388,9,24,1,33,0.3367616985444484
437,swap,10308.0,388,9,24,1,33,0.3367616985444484
438,swap,10308.0,388,9,24,1,33,0.3367616985444484
439,swap,10308.0,388,9,24,1,33,0.3367616985444484
440,swap,10009.0,389,9,23,1,32,0.33873303167420815
441,swap,10009.0,389,9,23,1,32,0.33873303167420815
442,swap,10009.0,389,9,23,1,32,0.33873303167420815
443,swap,10009.0,389,9,23,1,32,0.33873303167420815
444,swap,10009.0,389,9,23,1,32,0.33873303167420815
445,swap,10008.0,388,9,23,1,32,0.33868639480332
446,mut_micro,10008.0,388,9,23,1,32,0.33868639480332
447,swap,10008.0,388,9,23,1,32,0.33868639480332
448,reassign,10008.0,388,9,23,1,32,0.33868639480332
449,swap,10006.0,386,9,23,1,32,0.3378168340506934
450,swap,10003.0,383,9,23,1,32,0.33348142882530657
451,swap,10003.0,383,9,23,1,32,0.33348142882530657
452,swap,10003.0,383,9,23,1,32,0.33348142882530657
453,swap,10003.0,383,9,23,1,32,0.33348142882530657
454,swap,10003.0,383,9,23,1,32,0.33348142882530657
455,swap,10003.0,383,9,23,1,32,0.33348142882530657
456,swap,10003.0,383,9,23,1,32,0.33348142882530657
457,swap,10003.0,383,9,23,1,32,0.33348142882530657
458,swap,10002.0,382,9,23,1,32,0.33445546893456185
459,swap,10002.0,382,9,23,1,32,0.33445546893456185
460,swap,10002.0,382,9,23,1,32,0.33445546893456185
461,swap,10002.0,382,9,23,1,32,0.33445546893456185
462,swap,10002.0,382,9,23,1,32,0.33445546893456185
463,swap,10002.0,382,9,23,1,32,0.33445546893456185
464,swap,9703.0,383,9,22,1,31,0.33348142882530657
465,swap,9703.0,383,9,22,1,31,0.33348142882530657
466,swap,9703.0,383,9,22,1,31,0.33348142882530657
467,swap,9703.0,383,9,22,1,31,0.33348142882530657
468,swap,9703.0,383,9,22,1,31,0.33348142882530657
469,swap,9703.0,383,9,22,1,31,0.33348142882530657
470,swap,9703.0,383,9,22,1,31,0.33348142882530657
471,swap,9703.0,383,9,22,1,31,0.33348142882530657
472,swap,9703.0,383,9,22,1,31,0.33348142882530657
473,swap,9703.0,383,9,22,1,31,0.33348142882530657
474,swap,9703.0,383,9,22,1,31,0.33348142882530657
475,swap,9703.0,383,9,22,1,31,0.33348142882530657
476,swap,9703.0,383,9,22,1,31,0.33348142882530657
477,swap,9406.0,386,9,21,1,30,0.3378168340506934
478,swap,9406.0,386,9,21,1,30,0.3378168340506934
479,swap,9406.0,386,9,21,1,30,0.3378168340506934
480,swap,9406.0,386,9,21,1,30,0.3378168340506934
481,swap,9406.0,386,9,21,1,30,0.3378168340506934
482,swap,9406.0,386,9,21,1,30,0.3378168340506934
483,swap,9406.0,386,9,21,1,30,0.3378168340506934
484,swap,9406.0,386,9,21,1,30,0.3378168340506934
485,swap,9406.0,386,9,21,1,30,0.3378168340506934
486,swap,9406.0,386,9,21,1,30,0.3378168340506934
487,swap,9406.0,386,9,21,1,30,0.3378168340506934
488,swap,9406.0,386,9,21,1,30,0.3378168340506934
489,swap,9406.0,386,9,21,1,30,0.3378168340506934
490,swap,9406.0,386,9,21,1,30,0.3378168340506934
491,swap,9406.0,386,9,21,1,30,0.3378168340506934
492,swap,9406.0,386,9,21,1,30,0.3378168340506934
493,swap,9406.0,386,9,21,1,30,0.3378168340506934
494,swap,9406.0,386,9,21,1,30,0.3378168340506934
495,swap,9406.0,386,9,21,1,30,0.3378168340506934
496,swap,9406.0,386,9,21,1,30,0.3378168340506934
497,swap,9406.0,386,9,21,1,30,0.3378168340506934
498,swap,9406.0,386,9,21,1,30,0.3378168340506934
499,swap,9406.0,386,9,21,1,30,0.3378168340506934
500,swap,9406.0,386,9,21,1,30,0.3378168340506934
501,swap,9404.0,384,9,21,1,30,0.3368389780154486
502,reassign,9404.0,384,9,21,1,30,0.3368389780154486
503,reassign,9404.0,384,9,21,1,30,0.3368389780154486
504,swap,9404.0,384,9,21,1,30,0.3368389780154486
505,swap,9404.0,384,9,21,1,30,0.3368389780154486
506,swap,9404.0,384,9,21,1,30,0.3368389780154486
507,swap,9404.0,384,9,21,1,30,0.3368389780154486
508,swap,9404.0,384,9,21,1,30,0.3368389780154486
509,swap,9404.0,384,9,21,1,30,0.3368389780154486
510,swap,9404.0,384,9,21,1,30,0.3368389780154486
511,swap,9113.0,393,9,20,1,29,0.3445421782420134
512,swap,9113.0,393,9,20,1,29,0.3445421782420134
513,swap,9113.0,393,9,20,1,29,0.3445421782420134
514,swap,9113.0,393,9,20,1,29,0.3445421782420134
515,swap,9113.0,393,9,20,1,29,0.3445421782420134
516,swap,9113.0,393,9,20,1,29,0.3445421782420134
517,swap,9113.0,393,9,20,1,29,0.3445421782420134
518,swap,9113.0,393,9,20,1,29,0.3445421782420134
519,mut_micro,9113.0,393,9,20,1,29,0.3445421782420134
520,swap,9113.0,393,9,20,1,29,0.3445421782420134
521,swap,9113.0,393,9,20,1,29,0.3445421782420134
522,swap,9113.0,393,9,20,1,29,0.3445421782420134
523,swap,9113.0,393,9,20,1,29,0.3445421782420134
524,swap,9113.0,393,9,20,1,29,0.3445421782420134
525,swap,9113.0,393,9,20,1,29,0.3445421782420134
526,swap,9113.0,393,9,20,1,29,0.3445421782420134
527,swap,9113.0,393,9,20,1,29,0.3445421782420134
528,swap,9113.0,393,9,20,1,29,0.3445421782420134
529,swap,9113.0,393,9,20,1,29,0.3445421782420134
530,reassign,9113.0,393,9,20,1,29,0.3445421782420134
531,swap,9113.0,393,9,20,1,29,0.3445421782420134
532,swap,9113.0,393,9,20,1,29,0.3445421782420134
533,swap,9113.0,393,9,20,1,29,0.3445421782420134
534,swap,9113.0,393,9,20,1,29,0.3445421782420134
535,swap,9113.0,393,9,20,1,29,0.3445421782420134
536,swap,9113.0,393,9,20,1,29,0.3445421782420134
537,swap,9113.0,393,9,20,1,29,0.3445421782420134
538,swap,9113.0,393,9,20,1,29,0.3445421782420134
539,swap,9113.0,393,9,20,1,29,0.3445421782420134
540,swap,9113.0,393,9,20,1,29,0.3445421782420134
541,swap,9113.0,393,9,20,1,29,0.3445421782420134
542,swap,9113.0,393,9,20,1,29,0.3445421782420134
543,mut_micro,9113.0,393,9,20,1,29,0.3445421782420134
544,swap,9113.0,393,9,20,1,29,0.3445421782420134
545,reassign,9113.0,393,9,20,1,29,0.3445421782420134
546,swap,9113.0,393,9,20,1,29,0.3445421782420134
547,swap,8817.0,397,9,19,1,28,0.3487041504298881
548,swap,8817.0,397,9,19,1,28,0.3487041504298881
549,swap,8817.0,397,9,19,1,28,0.3487041504298881
550,swap,8817.0,397,9,19,1,28,0.3487041504298881
551,swap,8817.0,397,9,19,1,28,0.3487041504298881
552,swap,8817.0,397,9,19,1,28,0.3487041504298881
553,swap,8817.0,397,9,19,1,28,0.3487041504298881
554,swap,8817.0,397,9,19,1,28,0.3487041504298881
555,swap,8817.0,397,9,19,1,28,0.3487041504298881
556,swap,8817.0,397,9,19,1,28,0.3487041504298881
557,swap,8817.0,397,9,19,1,28,0.3487041504298881
558,swap,8817.0,397,9,19,1,28,0.3487041504298881
559,swap,8817.0,397,9,19,1,28,0.3487041504298881
560,swap,8817.0,397,9,19,1,28,0.3487041504298881
561,swap,8817.0,397,9,19,1,28,0.3487041504298881
562,swap,8817.0,397,9,19,1,28,0.3487041504298881
563,swap,8817.0,397,9,19,1,28,0.3487041504298881
564,swap,8817.0,397,9,19,1,28,0.3487041504298881
565,swap,8817.0,397,9,19,1,28,0.3487041504298881
566,swap,8817.0,397,9,19,1,28,0.3487041504298881
567,swap,8817.0,397,9,19,1,28,0.3487041504298881
568,swap,8817.0,397,9,19,1,28,0.3487041504298881
569,swap,8817.0,397,9,19,1,28,0.3487041504298881
570,swap,8817.0,397,9,19,1,28,0.3487041504298881
571,swap,8817.0,397,9,19,1,28,0.3487041504298881
572,swap,8817.0,397,9,19,1,28,0.3487041504298881
573,swap,8817.0,397,9,19,1,28,0.3487041504298881
574,mut_micro,8817.0,397,9,19,1,28,0.3487041504298881
575,swap,8817.0,397,9,19,1,28,0.3487041504298881
576,swap,8817.0,397,9,19,1,28,0.3487041504298881
577,swap,8817.0,397,9,19,1,28,0.3487041504298881
578,reassign,8817.0,397,9,19,1,28,0.3487041504298881
579,swap,8817.0,397,9,19,1,28,0.3487041504298881
580,swap,8817.0,397,9,19,1,28,0.3487041504298881
581,swap,8817.0,397,9,19,1,28,0.3487041504298881
582,swap,8817.0,397,9,19,1,28,0.3487041504298881
583,swap,8817.0,397,9,19,1,28,0.3487041504298881
584,swap,8817.0,397,9,19,1,28,0.3487041504298881
585,swap,8816.0,396,9,19,1,28,0.34683684794672603
586,mut_micro,8511.0,391,8,19,1,27,0.3436836034723487
587,swap,8511.0,391,8,19,1,27,0.3436836034723487
588,swap,8511.0,391,8,19,1,27,0.3436836034723487
589,swap,8511.0,391,8,19,1,27,0.3436836034723487
590,swap,8511.0,391,8,19,1,27,0.3436836034723487
591,swap,8511.0,391,8,19,1,27,0.3436836034723487
592,swap,8511.0,391,8,19,1,27,0.3436836034723487
593,swap,8511.0,391,8,19,1,27,0.3436836034723487
594,swap,8511.0,391,8,19,1,27,0.3436836034723487
595,swap,8511.0,391,8,19,1,27,0.3436836034723487
596,swap,8511.0,391,8,19,1,27,0.3436836034723487
597,swap,8511.0,391,8,19,1,27,0.3436836034723487
598,mut_micro,8511.0,391,8,19,1,27,0.3436836034723487
599,swap,8511.0,391,8,19,1,27,0.3436836034723487
600,swap,8511.0,391,8,19,1,27,0.3436836034723487
601,swap,8511.0,391,8,19,1,27,0.3436836034723487
602,swap,8511.0,391,8,19,1,27,0.3436836034723487
603,swap,8511.0,391,8,19,1,27,0.3436836034723487
604,swap,8511.0,391,8,19,1,27,0.3436836034723487
605,swap,8511.0,391,8,19,1,27,0.3436836034723487
606,swap,8511.0,391,8,19,1,27,0.3436836034723487
607,swap,8511.0,391,8,19,1,27,0.3436836034723487
608,swap,8511.0,391,8,19,1,27,0.3436836034723487
609,swap,8511.0,391,8,19,1,27,0.3436836034723487
610,swap,8511.0,391,8,19,1,27,0.3436836034723487
611,swap,8511.0,391,8,19,1,27,0.3436836034723487
612,swap,8511.0,391,8,19,1,27,0.3436836034723487
613,swap,8511.0,391,8,19,1,27,0.3436836034723487
614,swap,8511.0,391,8,19,1,27,0.3436836034723487
615,swap,8511.0,391,8,19,1,27,0.3436836034723487
616,swap,8511.0,391,8,19,1,27,0.3436836034723487
617,reassign,8511.0,391,8,19,1,27,0.3436836034723487
618,swap,8511.0,391,8,19,1,27,0.3436836034723487
619,swap,8511.0,391,8,19,1,27,0.3436836034723487
620,swap,8511.0,391,8,19,1,27,0.3436836034723487
621,swap,8511.0,391,8,19,1,27,0.3436836034723487
622,swap,8511.0,391,8,19,1,27,0.3436836034723487
623,swap,8511.0,391,8,19,1,27,0.3436836034723487
624,swap,8511.0,391,8,19,1,27,0.3436836034723487
625,swap,8511.0,391,8,19,1,27,0.3436836034723487
626,swap,8511.0,391,8,19,1,27,0.3436836034723487
627,swap,8511.0,391,8,19,1,27,0.3436836034723487
628,swap,8511.0,391,8,19,1,27,0.3436836034723487
629,swap,8511.0,391,8,19,1,27,0.3436836034723487
630,swap,8511.0,391,8,19,1,27,0.3436836034723487
631,swap,8511.0,391,8,19,1,27,0.3436836034723487
632,swap,8511.0,391,8,19,1,27,0.3436836034723487
633,swap,8511.0,391,8,19,1,27,0.3436836034723487
634,swap,8511.0,391,8,19,1,27,0.3436836034723487
635,swap,8511.0,391,8,19,1,27,0.3436836034723487
636,mut_micro,8511.0,391,8,19,1,27,0.3436836034723487
637,swap,8511.0,391,8,19,1,27,0.3436836034723487
638,swap,8511.0,391,8,19,1,27,0.3436836034723487
639,swap,8511.0,391,8,19,1,27,0.3436836034723487
640,swap,8511.0,391,8,19,1,27,0.3436836034723487
641,swap,8511.0,391,8,19,1,27,0.3436836034723487
642,swap,8511.0,391,8,19,1,27,0.3436836034723487
643,swap,8216.0,396,8,18,1,26,0.34683684794672603
644,swap,8216.0,396,8,18,1,26,0.34683684794672603
645,swap,8216.0,396,8,18,1,26,0.34683684794672603
646,swap,8216.0,396,8,18,1,26,0.34683684794672603
647,swap,8216.0,396,8,18,1,26,0.34683684794672603
648,swap,7924.0,404,8,17,1,25,0.354775458570525
649,swap,7923.0,403,8,17,1,25,0.3529096526070235
650,swap,7923.0,403,8,17,1,25,0.3529096526070235
651,reassign,7923.0,403,8,17,1,25,0.3529096526070235
652,swap,7923.0,403,8,17,1,25,0.3529096526070235
653,swap,7923.0,403,8,17,1,25,0.3529096526070235
654,swap,7923.0,403,8,17,1,25,0.3529096526070235
655,swap,7923.0,403,8,17,1,25,0.3529096526070235
656,swap,7923.0,403,8,17,1,25,0.3529096526070235
657,swap,7923.0,403,8,17,1,25,0.3529096526070235
658,swap,7923.0,403,8,17,1,25,0.3529096526070235
659,swap,7923.0,403,8,17,1,25,0.3529096526070235
660,mut_micro,7923.0,403,8,17,1,25,0.3529096526070235
661,swap,7923.0,403,8,17,1,25,0.3529096526070235
662,swap,7923.0,403,8,17,1,25,0.3529096526070235
663,swap,7923.0,403,8,17,1,25,0.3529096526070235
664,swap,7923.0,403,8,17,1,25,0.3529096526070235
665,swap,7923.0,403,8,17,1,25,0.3529096526070235
666,swap,7923.0,403,8,17,1,25,0.3529096526070235
667,swap,7923.0,403,8,17,1,25,0.3529096526070235
668,swap,7923.0,403,8,17,1,25,0.3529096526070235
669,swap,7923.0,403,8,17,1,25,0.3529096526070235
670,swap,7923.0,403,8,17,1,25,0.3529096526070235
671,swap,7923.0,403,8,17,1,25,0.3529096526070235
672,swap,7922.0,402,8,17,1,25,0.35224987430869786
673,swap,7922.0,402,8,17,1,25,0.35224987430869786
674,swap,7922.0,402,8,17,1,25,0.35224987430869786
675,swap,7922.0,402,8,17,1,25,0.35224987430869786
676,swap,7922.0,402,8,17,1,25,0.35224987430869786
677,swap,7920.0,400,8,17,1,25,0.3533158486324466
678,swap,7920.0,400,8,17,1,25,0.3533158486324466
679,swap,7920.0,400,8,17,1,25,0.3533158486324466
680,reassign,7920.0,400,8,17,1,25,0.3533158486324466
681,swap,7920.0,400,8,17,1,25,0.3533158486324466
682,swap,7920.0,400,8,17,1,25,0.3533158486324466
683,swap,7920.0,400,8,17,1,25,0.3533158486324466
684,swap,7920.0,400,8,17,1,25,0.3533158486324466
685,swap,7920.0,400,8,17,1,25,0.3533158486324466
686,swap,7920.0,400,8,17,1,25,0.3533158486324466
687,swap,7920.0,400,8,17,1,25,0.3533158486324466
688,swap,7920.0,400,8,17,1,25,0.3533158486324466
689,swap,7920.0,400,8,17,1,25,0.3533158486324466
690,swap,7920.0,400,8,17,1,25,0.3533158486324466
691,swap,7920.0,400,8,17,1,25,0.3533158486324466
692,swap,7920.0,400,8,17,1,25,0.3533158486324466
693,swap,7920.0,400,8,17,1,25,0.3533158486324466
694,swap,7920.0,400,8,17,1,25,0.3533158486324466
695,swap,7920.0,400,8,17,1,25,0.3533158486324466
696,swap,7920.0,400,8,17,1,25,0.3533158486324466
697,swap,7920.0,400,8,17,1,25,0.3533158486324466
698,swap,7920.0,400,8,17,1,25,0.3533158486324466
699,swap,7920.0,400,8,17,1,25,0.3533158486324466
700,reassign,7920.0,400,8,17,1,25,0.3533158486324466
701,swap,7920.0,400,8,17,1,25,0.3533158486324466
702,swap,7920.0,400,8,17,1,25,0.3533158486324466
703,swap,7920.0,400,8,17,1,25,0.3533158486324466
704,swap,7920.0,400,8,17,1,25,0.3533158486324466
705,swap,7920.0,400,8,17,1,25,0.3533158486324466
706,swap,7920.0,400,8,17,1,25,0.3533158486324466
707,swap,7920.0,400,8,17,1,25,0.3533158486324466
708,swap,7920.0,400,8,17,1,25,0.3533158486324466
709,swap,7920.0,400,8,17,1,25,0.3533158486324466
710,swap,7920.0,400,8,17,1,25,0.3533158486324466
711,swap,7920.0,400,8,17,1,25,0.3533158486324466
712,swap,7920.0,400,8,17,1,25,0.3533158486324466
713,reassign,7920.0,400,8,17,1,25,0.3533158486324466
714,swap,7920.0,400,8,17,1,25,0.3533158486324466
715,swap,7920.0,400,8,17,1,25,0.3533158486324466
716,swap,7920.0,400,8,17,1,25,0.3533158486324466
717,swap,7920.0,400,8,17,1,25,0.3533158486324466
718,mut_micro,7920.0,400,8,17,1,25,0.3533158486324466
719,swap,7920.0,400,8,17,1,25,0.3533158486324466
720,swap,7920.0,400,8,17,1,25,0.3533158486324466
721,swap,7920.0,400,8,17,1,25,0.3533158486324466
722,swap,7920.0,400,8,17,1,25,0.3533158486324466
723,swap,7920.0,400,8,17,1,25,0.3533158486324466
724,swap,7920.0,400,8,17,1,25,0.3533158486324466
725,swap,7920.0,400,8,17,1,25,0.3533158486324466
726,swap,7920.0,400,8,17,1,25,0.3533158486324466
727,swap,7920.0,400,8,17,1,25,0.3533158486324466
728,swap,7920.0,400,8,17,1,25,0.3533158486324466
729,swap,7920.0,400,8,17,1,25,0.3533158486324466
730,reassign,7920.0,400,8,17,1,25,0.3533158486324466
731,swap,7920.0,400,8,17,1,25,0.3533158486324466
732,swap,7920.0,400,8,17,1,25,0.3533158486324466
733,swap,7920.0,400,8,17,1,25,0.3533158486324466
734,swap,7920.0,400,8,17,1,25,0.3533158486324466
735,swap,7920.0,400,8,17,1,25,0.3533158486324466
736,swap,7920.0,400,8,17,1,25,0.3533158486324466
737,swap,7920.0,400,8,17,1,25,0.3533158486324466
738,swap,7920.0,400,8,17,1,25,0.3533158486324466
739,swap,7920.0,400,8,17,1,25,0.3533158486324466
740,swap,7920.0,400,8,17,1,25,0.3533158486324466
741,swap,7920.0,400,8,17,1,25,0.3533158486324466
742,swap,7920.0,400,8,17,1,25,0.3533158486324466
743,swap,7920.0,400,8,17,1,25,0.3533158486324466
744,swap,7920.0,400,8,17,1,25,0.3533158486324466
745,swap,7920.0,400,8,17,1,25,0.3533158486324466
746,swap,7920.0,400,8,17,1,25,0.3533158486324466
747,swap,7920.0,400,8,17,1,25,0.3533158486324466
748,swap,7920.0,400,8,17,1,25,0.3533158486324466
749,swap,7920.0,400,8,17,1,25,0.3533158486324466
750,swap,7920.0,400,8,17,1,25,0.3533158486324466
751,mut_micro,7920.0,400,8,17,1,25,0.3533158486324466
752,swap,7920.0,400,8,17,1,25,0.3533158486324466
753,swap,7920.0,400,8,17,1,25,0.3533158486324466
754,swap,7920.0,400,8,17,1,25,0.3533158486324466
755,swap,7920.0,400,8,17,1,25,0.3533158486324466
756,swap,7920.0,400,8,17,1,25,0.3533158486324466
757,swap,7920.0,400,8,17,1,25,0.3533158486324466
758,swap,7920.0,400,8,17,1,25,0.3533158486324466
759,swap,7920.0,400,8,17,1,25,0.3533158486324466
760,swap,7920.0,400,8,17,1,25,0.3533158486324466
761,swap,7919.0,399,8,17,1,25,0.3525988173046996
762,swap,7919.0,399,8,17,1,25,0.3525988173046996
763,swap,7919.0,399,8,17,1,25,0.3525988173046996
764,swap,7919.0,399,8,17,1,25,0.3525988173046996
765,swap,7919.0,399,8,17,1,25,0.3525988173046996
766,swap,7919.0,399,8,17,1,25,0.3525988173046996
767,swap,7919.0,399,8,17,1,25,0.3525988173046996
768,swap,7919.0,399,8,17,1,25,0.3525988173046996
769,swap,7919.0,399,8,17,1,25,0.3525988173046996
770,swap,7919.0,399,8,17,1,25,0.3525988173046996
771,swap,7919.0,399,8,17,1,25,0.3525988173046996
772,swap,7919.0,399,8,17,1,25,0.3525988173046996
773,swap,7918.0,398,8,17,1,25,0.3535616778356912
774,swap,7918.0,398,8,17,1,25,0.3535616778356912
775,swap,7918.0,398,8,17,1,25,0.3535616778356912
776,swap,7918.0,398,8,17,1,25,0.3535616778356912
777,swap,7918.0,398,8,17,1,25,0.3535616778356912
778,swap,7918.0,398,8,17,1,25,0.3535616778356912
779,swap,7917.0,397,8,17,1,25,0.35445660914207955
780,swap,7917.0,397,8,17,1,25,0.35445660914207955
781,swap,7917.0,397,8,17,1,25,0.35445660914207955
782,swap,7917.0,397,8,17,1,25,0.35445660914207955
783,mut_micro,7917.0,397,8,17,1,25,0.35445660914207955
784,swap,7917.0,397,8,17,1,25,0.35445660914207955
785,swap,7917.0,397,8,17,1,25,0.35445660914207955
786,swap,7917.0,397,8,17,1,25,0.35445660914207955
787,swap,7917.0,397,8,17,1,25,0.35445660914207955
788,swap,7917.0,397,8,17,1,25,0.35445660914207955
789,swap,7917.0,397,8,17,1,25,0.35445660914207955
790,swap,7917.0,397,8,17,1,25,0.35445660914207955
791,swap,7917.0,397,8,17,1,25,0.35445660914207955
792,swap,7917.0,397,8,17,1,25,0.35445660914207955
793,swap,7917.0,397,8,17,1,25,0.35445660914207955
794,swap,7917.0,397,8,17,1,25,0.35445660914207955
795,swap,7917.0,397,8,17,1,25,0.35445660914207955
796,swap,7917.0,397,8,17,1,25,0.35445660914207955
797,swap,7917.0,397,8,17,1,25,0.35445660914207955
798,swap,7917.0,397,8,17,1,25,0.35445660914207955
799,swap,7917.0,397,8,17,1,25,0.35445660914207955
800,swap,7917.0,397,8,17,1,25,0.35445660914207955
801,swap,7917.0,397,8,17,1,25,0.35445660914207955
802,swap,7917.0,397,8,17,1,25,0.35445660914207955
803,swap,7917.0,397,8,17,1,25,0.35445660914207955
804,swap,7917.0,397,8,17,1,25,0.35445660914207955
805,swap,7917.0,397,8,17,1,25,0.35445660914207955
806,swap,7917.0,397,8,17,1,25,0.35445660914207955
807,swap,7914.0,394,8,17,1,25,0.35042892156862737
808,swap,7914.0,394,8,17,1,25,0.35042892156862737
809,swap,7914.0,394,8,17,1,25,0.35042892156862737
810,swap,7914.0,394,8,17,1,25,0.35042892156862737
811,swap,7914.0,394,8,17,1,25,0.35042892156862737
812,swap,7914.0,394,8,17,1,25,0.35042892156862737
813,swap,7914.0,394,8,17,1,25,0.35042892156862737
814,swap,7912.0,392,8,17,1,25,0.3470953598830836
815,swap,7912.0,392,8,17,1,25,0.3470953598830836
816,swap,7912.0,392,8,17,1,25,0.3470953598830836
817,swap,7907.0,387,8,17,1,25,0.3437368831324579
818,swap,7907.0,387,8,17,1,25,0.3437368831324579
819,swap,7907.0,387,8,17,1,25,0.3437368831324579
820,swap,7907.0,387,8,17,1,25,0.3437368831324579
821,swap,7907.0,387,8,17,1,25,0.3437368831324579
822,swap,7907.0,387,8,17,1,25,0.3437368831324579
823,mut_micro,7907.0,387,8,17,1,25,0.3437368831324579
824,swap,7907.0,387,8,17,1,25,0.3437368831324579
825,swap,7907.0,387,8,17,1,25,0.3437368831324579
826,swap,7907.0,387,8,17,1,25,0.3437368831324579
827,swap,7907.0,387,8,17,1,25,0.3437368831324579
828,swap,7907.0,387,8,17,1,25,0.3437368831324579
829,swap,7907.0,387,8,17,1,25,0.3437368831324579
830,swap,7907.0,387,8,17,1,25,0.3437368831324579
831,swap,7907.0,387,8,17,1,25,0.3437368831324579
832,swap,7907.0,387,8,17,1,25,0.3437368831324579
833,mut_micro,7907.0,387,8,17,1,25,0.3437368831324579
834,swap,7907.0,387,8,17,1,25,0.3437368831324579
835,swap,7907.0,387,8,17,1,25,0.3437368831324579
836,swap,7907.0,387,8,17,1,25,0.3437368831324579
837,swap,7907.0,387,8,17,1,25,0.3437368831324579
838,swap,7907.0,387,8,17,1,25,0.3437368831324579
839,swap,7907.0,387,8,17,1,25,0.3437368831324579
840,reassign,7907.0,387,8,17,1,25,0.3437368831324579
841,mut_micro,7907.0,387,8,17,1,25,0.3437368831324579
842,swap,7907.0,387,8,17,1,25,0.3437368831324579
843,swap,7907.0,387,8,17,1,25,0.3437368831324579
844,swap,7907.0,387,8,17,1,25,0.3437368831324579
845,swap,7907.0,387,8,17,1,25,0.3437368831324579
846,swap,7907.0,387,8,17,1,25,0.3437368831324579
847,swap,7907.0,387,8,17,1,25,0.3437368831324579
848,reassign,7907.0,387,8,17,1,25,0.3437368831324579
849,swap,7907.0,387,8,17,1,25,0.3437368831324579
850,swap,7907.0,387,8,17,1,25,0.3437368831324579
851,swap,7907.0,387,8,17,1,25,0.3437368831324579
852,swap,7907.0,387,8,17,1,25,0.3437368831324579
853,swap,7907.0,387,8,17,1,25,0.3437368831324579
854,swap,7907.0,387,8,17,1,25,0.3437368831324579
855,swap,7907.0,387,8,17,1,25,0.3437368831324579
856,swap,7907.0,387,8,17,1,25,0.3437368831324579
857,swap,7907.0,387,8,17,1,25,0.3437368831324579
858,swap,7907.0,387,8,17,1,25,0.3437368831324579
859,swap,7907.0,387,8,17,1,25,0.3437368831324579
860,reassign,7907.0,387,8,17,1,25,0.3437368831324579
861,swap,7907.0,387,8,17,1,25,0.3437368831324579
862,swap,7907.0,387,8,17,1,25,0.3437368831324579
863,swap,7907.0,387,8,17,1,25,0.3437368831324579
864,swap,7907.0,387,8,17,1,25,0.3437368831324579
865,swap,7907.0,387,8,17,1,25,0.3437368831324579
866,swap,7907.0,387,8,17,1,25,0.3437368831324579
867,swap,7907.0,387,8,17,1,25,0.3437368831324579
868,swap,7907.0,387,8,17,1,25,0.3437368831324579
869,swap,7907.0,387,8,17,1,25,0.3437368831324579
870,swap,7907.0,387,8,17,1,25,0.3437368831324579
871,swap,7907.0,387,8,17,1,25,0.3437368831324579
872,swap,7907.0,387,8,17,1,25,0.3437368831324579
873,swap,7907.0,387,8,17,1,25,0.3437368831324579
874,swap,7904.0,384,8,17,1,25,0.343612596553773
875,swap,7904.0,384,8,17,1,25,0.343612596553773
876,swap,7904.0,384,8,17,1,25,0.343612596553773
877,swap,7904.0,384,8,17,1,25,0.343612596553773
878,mut_micro,7904.0,384,8,17,1,25,0.343612596553773
879,swap,7904.0,384,8,17,1,25,0.343612596553773
880,swap,7904.0,384,8,17,1,25,0.343612596553773
881,swap,7904.0,384,8,17,1,25,0.343612596553773
882,swap,7904.0,384,8,17,1,25,0.343612596553773
883,swap,7904.0,384,8,17,1,25,0.343612596553773
884,swap,7904.0,384,8,17,1,25,0.343612596553773
885,swap,7904.0,384,8,17,1,25,0.343612596553773
886,swap,7904.0,384,8,17,1,25,0.343612596553773
887,mut_micro,7904.0,384,8,17,1,25,0.343612596553773
888,reassign,7904.0,384,8,17,1,25,0.343612596553773
889,swap,7904.0,384,8,17,1,25,0.343612596553773
890,swap,7904.0,384,8,17,1,25,0.343612596553773
891,swap,7904.0,384,8,17,1,25,0.343612596553773
892,swap,7904.0,384,8,17,1,25,0.343612596553773
893,reassign,7904.0,384,8,17,1,25,0.343612596553773
894,swap,7904.0,384,8,17,1,25,0.343612596553773
895,swap,7904.0,384,8,17,1,25,0.343612596553773
896,swap,7904.0,384,8,17,1,25,0.343612596553773
897,swap,7904.0,384,8,17,1,25,0.343612596553773
898,swap,7904.0,384,8,17,1,25,0.343612596553773
899,swap,7904.0,384,8,17,1,25,0.343612596553773
900,swap,7904.0,384,8,17,1,25,0.343612596553773
901,swap,7904.0,384,8,17,1,25,0.343612596553773
902,swap,7904.0,384,8,17,1,25,0.343612596553773
903,swap,7609.0,389,8,16,1,24,0.3471191553544494
904,swap,7609.0,389,8,16,1,24,0.3471191553544494
905,swap,7609.0,389,8,16,1,24,0.3471191553544494
906,swap,7609.0,389,8,16,1,24,0.3471191553544494
907,swap,7609.0,389,8,16,1,24,0.3471191553544494
908,swap,7609.0,389,8,16,1,24,0.3471191553544494
909,swap,7609.0,389,8,16,1,24,0.3471191553544494
910,swap,7609.0,389,8,16,1,24,0.3471191553544494
911,swap,7609.0,389,8,16,1,24,0.3471191553544494
912,swap,7609.0,389,8,16,1,24,0.3471191553544494
913,mut_micro,7609.0,389,8,16,1,24,0.3471191553544494
914,swap,7609.0,389,8,16,1,24,0.3471191553544494
915,swap,7609.0,389,8,16,1,24,0.3471191553544494
916,swap,7609.0,389,8,16,1,24,0.3471191553544494
917,swap,7609.0,389,8,16,1,24,0.3471191553544494
918,swap,7609.0,389,8,16,1,24,0.3471191553544494
919,swap,7609.0,389,8,16,1,24,0.3471191553544494
920,swap,7609.0,389,8,16,1,24,0.3471191553544494
921,swap,7609.0,389,8,16,1,24,0.3471191553544494
922,swap,7609.0,389,8,16,1,24,0.3471191553544494
923,swap,7609.0,389,8,16,1,24,0.3471191553544494
924,swap,7609.0,389,8,16,1,24,0.3471191553544494
925,swap,7609.0,389,8,16,1,24,0.3471191553544494
926,swap,7609.0,389,8,16,1,24,0.3471191553544494
927,swap,7609.0,389,8,16,1,24,0.3471191553544494
928,reassign,7609.0,389,8,16,1,24,0.3471191553544494
929,swap,7609.0,389,8,16,1,24,0.3471191553544494
930,swap,7609.0,389,8,16,1,24,0.3471191553544494
931,swap,7609.0,389,8,16,1,24,0.3471191553544494
932,swap,7609.0,389,8,16,1,24,0.3471191553544494
933,swap,7609.0,389,8,16,1,24,0.3471191553544494
934,swap,7609.0,389,8,16,1,24,0.3471191553544494
935,swap,7609.0,389,8,16,1,24,0.3471191553544494
936,swap,7609.0,389,8,16,1,24,0.3471191553544494
937,reassign,7609.0,389,8,16,1,24,0.3471191553544494
938,swap,7609.0,389,8,16,1,24,0.3471191553544494
939,swap,7609.0,389,8,16,1,24,0.3471191553544494
940,swap,7609.0,389,8,16,1,24,0.3471191553544494
941,swap,7609.0,389,8,16,1,24,0.3471191553544494
942,swap,7609.0,389,8,16,1,24,0.3471191553544494
943,swap,7609.0,389,8,16,1,24,0.3471191553544494
944,swap,7609.0,389,8,16,1,24,0.3471191553544494
945,swap,7609.0,389,8,16,1,24,0.3471191553544494
946,swap,7609.0,389,8,16,1,24,0.3471191553544494
947,swap,7609.0,389,8,16,1,24,0.3471191553544494
948,swap,7609.0,389,8,16,1,24,0.3471191553544494
949,swap,7609.0,389,8,16,1,24,0.3471191553544494
950,swap,7605.0,385,8,16,1,24,0.3455211871982836
951,swap,7605.0,385,8,16,1,24,0.3455211871982836
952,swap,7605.0,385,8,16,1,24,0.3455211871982836
953,swap,7605.0,385,8,16,1,24,0.3455211871982836
954,reassign,7605.0,385,8,16,1,24,0.3455211871982836
955,swap,7605.0,385,8,16,1,24,0.3455211871982836
956,reassign,7605.0,385,8,16,1,24,0.3455211871982836
957,swap,7605.0,385,8,16,1,24,0.3455211871982836
958,swap,7605.0,385,8,16,1,24,0.3455211871982836
959,swap,7605.0,385,8,16,1,24,0.3455211871982836
960,swap,7605.0,385,8,16,1,24,0.3455211871982836
961,swap,7605.0,385,8,16,1,24,0.3455211871982836
962,swap,7605.0,385,8,16,1,24,0.3455211871982836
963,reassign,7605.0,385,8,16,1,24,0.3455211871982836
964,swap,7605.0,385,8,16,1,24,0.3455211871982836
965,swap,7605.0,385,8,16,1,24,0.3455211871982836
966,swap,7605.0,385,8,16,1,24,0.3455211871982836
967,swap,7605.0,385,8,16,1,24,0.3455211871982836
968,swap,7600.0,380,8,16,1,24,0.3418457203240577
969,swap,7600.0,380,8,16,1,24,0.3418457203240577
970,swap,7600.0,380,8,16,1,24,0.3418457203240577
971,swap,7600.0,380,8,16,1,24,0.3418457203240577
972,swap,7600.0,380,8,16,1,24,0.3418457203240577
973,swap,7600.0,380,8,16,1,24,0.3418457203240577
974,swap,7600.0,380,8,16,1,24,0.3418457203240577
975,swap,7600.0,380,8,16,1,24,0.3418457203240577
976,swap,7600.0,380,8,16,1,24,0.3418457203240577
977,mut_micro,7600.0,380,8,16,1,24,0.3418457203240577
978,swap,7600.0,380,8,16,1,24,0.3418457203240577
979,swap,7600.0,380,8,16,1,24,0.3418457203240577
980,swap,7600.0,380,8,16,1,24,0.3418457203240577
981,swap,7600.0,380,8,16,1,24,0.3418457203240577
982,swap,7600.0,380,8,16,1,24,0.3418457203240577
983,swap,7600.0,380,8,16,1,24,0.3418457203240577
984,swap,7600.0,380,8,16,1,24,0.3418457203240577
985,swap,7600.0,380,8,16,1,24,0.3418457203240577
986,swap,7600.0,380,8,16,1,24,0.3418457203240577
987,swap,7600.0,380,8,16,1,24,0.3418457203240577
988,reassign,7600.0,380,8,16,1,24,0.3418457203240577
989,swap,7600.0,380,8,16,1,24,0.3418457203240577
990,swap,7600.0,380,8,16,1,24,0.3418457203240577
991,swap,7600.0,380,8,16,1,24,0.3418457203240577
992,swap,7600.0,380,8,16,1,24,0.3418457203240577
993,swap,7308.0,388,8,15,1,23,0.3496932515337423
994,swap,7308.0,388,8,15,1,23,0.3496932515337423
995,swap,7308.0,388,8,15,1,23,0.3496932515337423
996,swap,7308.0,388,8,15,1,23,0.3496932515337423
997,swap,7308.0,388,8,15,1,23,0.3496932515337423
998,swap,7308.0,388,8,15,1,23,0.3496932515337423
999,swap,7308.0,388,8,15,1,23,0.3496932515337423
1000,swap,7308.0,388,8,15,1,23,0.3496932515337423
