iter,op,fitness_score,pref_penalty,capacity_viol,elig_viol,under_cap,total_violations,gini
1,swap,27631.0,351,33,57,14,90,0.2554151137038839
2,swap,27339.0,359,33,56,14,89,0.26536868268434144
3,swap,27339.0,359,33,56,14,89,0.26536868268434144
4,reassign,27339.0,359,33,56,14,89,0.26536868268434144
5,mut_micro,26438.0,358,32,54,14,86,0.26349416170962775
6,mut_micro,26438.0,358,32,54,14,86,0.26349416170962775
7,mut_micro,26135.0,355,31,54,14,85,0.2643781746681961
8,mut_micro,25838.0,358,31,53,14,84,0.2696078431372549
9,mut_micro,25838.0,358,31,53,14,84,0.2696078431372549
10,mut_micro,25235.0,355,30,52,14,82,0.2703315309410673
11,mut_micro,25235.0,355,30,52,14,82,0.2703315309410673
12,reassign,25235.0,355,30,52,14,82,0.2703315309410673
13,mut_micro,24316.0,356,28,51,13,79,0.2729762295979845
14,mut_micro,24316.0,356,28,51,13,79,0.2729762295979845
15,mut_micro,24316.0,356,28,51,13,79,0.2729762295979845
16,mut_micro,23714.0,354,27,50,13,77,0.2742374727668844
17,reassign,23714.0,354,27,50,13,77,0.2742374727668844
18,mut_micro,23714.0,354,27,50,13,77,0.2742374727668844
19,mut_micro,23714.0,354,27,50,13,77,0.2742374727668844
20,mut_micro,23675.0,355,26,51,11,77,0.2768310666885138
21,mut_micro,23675.0,355,26,51,11,77,0.2768310666885138
22,mut_micro,23675.0,355,26,51,11,77,0.2768310666885138
23,mut_micro,23673.0,353,26,51,11,77,0.27622073760252025
24,mut_micro,23671.0,351,26,51,11,77,0.2772916329066062
25,mut_micro,23671.0,351,26,51,11,77,0.2772916329066062
26,mut_micro,23671.0,351,26,51,11,77,0.2772916329066062
27,mut_micro,23374.0,354,25,51,11,76,0.27979302832243996
28,mut_micro,23374.0,354,25,51,11,76,0.27979302832243996
29,mut_micro,23374.0,354,25,51,11,76,0.27979302832243996
30,mut_micro,23374.0,354,25,51,11,76,0.27979302832243996
31,mut_micro,23075.0,355,25,50,11,75,0.2815828281173193
32,mut_micro,23074.0,354,25,50,11,75,0.282516339869281
33,mut_micro,23074.0,354,25,50,11,75,0.282516339869281
34,swap,23074.0,354,25,50,11,75,0.282516339869281
35,swap,23074.0,354,25,50,11,75,0.282516339869281
36,mut_micro,23074.0,354,25,50,11,75,0.282516339869281
37,swap,23074.0,354,25,50,11,75,0.282516339869281
38,swap,23074.0,354,25,50,11,75,0.282516339869281
39,swap,23074.0,354,25,50,11,75,0.282516339869281
40,swap,23074.0,354,25,50,11,75,0.282516339869281
41,swap,23074.0,354,25,50,11,75,0.282516339869281
42,swap,23074.0,354,25,50,11,75,0.282516339869281
43,swap,22777.0,357,25,49,11,74,0.28936672708299005
44,swap,22777.0,357,25,49,11,74,0.28936672708299005
45,swap,22484.0,364,25,48,11,73,0.2922128851540618
46,swap,22484.0,364,25,48,11,73,0.2922128851540618
47,swap,22484.0,364,25,48,11,73,0.2922128851540618
48,swap,22188.0,368,25,47,11,72,0.29695115040235737
49,swap,22188.0,368,25,47,11,72,0.29695115040235737
50,mut_micro,22188.0,368,25,47,11,72,0.29695115040235737
51,swap,22188.0,368,25,47,11,72,0.29695115040235737
52,swap,22188.0,368,25,47,11,72,0.29695115040235737
53,swap,22188.0,368,25,47,11,72,0.29695115040235737
54,swap,22188.0,368,25,47,11,72,0.29695115040235737
55,swap,22188.0,368,25,47,11,72,0.29695115040235737
56,mut_micro,22187.0,367,25,47,11,72,0.2971407583206193
57,swap,22187.0,367,25,47,11,72,0.2971407583206193
58,swap,22187.0,367,25,47,11,72,0.2971407583206193
59,swap,22187.0,367,25,47,11,72,0.2971407583206193
60,swap,22187.0,367,25,47,11,72,0.2971407583206193
61,swap,22187.0,367,25,47,11,72,0.2971407583206193
62,swap,22187.0,367,25,47,11,72,0.2971407583206193
63,swap,21892.0,372,25,46,11,71,0.30076826052058253
64,swap,21892.0,372,25,46,11,71,0.30076826052058253
65,swap,21892.0,372,25,46,11,71,0.30076826052058253
66,swap,21892.0,372,25,46,11,71,0.30076826052058253
67,swap,21892.0,372,25,46,11,71,0.30076826052058253
68,mut_micro,21892.0,372,25,46,11,71,0.30076826052058253
69,swap,21892.0,372,25,46,11,71,0.30076826052058253
70,swap,21892.0,372,25,46,11,71,0.30076826052058253
71,swap,21892.0,372,25,46,11,71,0.30076826052058253
72,swap,21892.0,372,25,46,11,71,0.30076826052058253
73,swap,21592.0,372,25,45,11,70,0.30076826052058253
74,swap,21591.0,371,25,45,11,70,0.30180643686045844
75,swap,21591.0,371,25,45,11,70,0.30180643686045844
76,swap,21591.0,371,25,45,11,70,0.30180643686045844
77,swap,21591.0,371,25,45,11,70,0.30180643686045844
78,swap,21591.0,371,25,45,11,70,0.30180643686045844
79,swap,21591.0,371,25,45,11,70,0.30180643686045844
80,swap,21591.0,371,25,45,11,70,0.30180643686045844
81,swap,21289.0,369,25,44,11,69,0.3029553850525717
82,swap,20992.0,372,25,43,11,68,0.3094828574704736
83,swap,20992.0,372,25,43,11,68,0.3094828574704736
84,swap,20992.0,372,25,43,11,68,0.3094828574704736
85,swap,20992.0,372,25,43,11,68,0.3094828574704736
86,swap,20992.0,372,25,43,11,68,0.3094828574704736
87,swap,20992.0,372,25,43,11,68,0.3094828574704736
88,swap,20992.0,372,25,43,11,68,0.3094828574704736
89,swap,20992.0,372,25,43,11,68,0.3094828574704736
90,swap,20992.0,372,25,43,11,68,0.3094828574704736
91,swap,20992.0,372,25,43,11,68,0.3094828574704736
92,swap,20992.0,372,25,43,11,68,0.3094828574704736
93,swap,20992.0,372,25,43,11,68,0.3094828574704736
94,swap,20688.0,368,25,42,11,67,0.3048282896973818
95,swap,20688.0,368,25,42,11,67,0.3048282896973818
96,swap,20688.0,368,25,42,11,67,0.3048282896973818
97,swap,20688.0,368,25,42,11,67,0.3048282896973818
98,swap,20688.0,368,25,42,11,67,0.3048282896973818
99,swap,20688.0,368,25,42,11,67,0.3048282896973818
100,swap,20688.0,368,25,42,11,67,0.3048282896973818
101,swap,20389.0,369,25,41,11,66,0.3064791133844841
102,swap,20389.0,369,25,41,11,66,0.3064791133844841
103,swap,20389.0,369,25,41,11,66,0.3064791133844841
104,swap,20094.0,374,25,40,11,65,0.3101499423298732
105,swap,20094.0,374,25,40,11,65,0.3101499423298732
106,reassign,19793.0,373,24,40,11,64,0.31110919441090235
107,mut_micro,19793.0,373,24,40,11,64,0.31110919441090235
108,swap,19793.0,373,24,40,11,64,0.31110919441090235
109,mut_micro,19789.0,369,24,40,11,64,0.3064791133844841
110,swap,19789.0,369,24,40,11,64,0.3064791133844841
111,swap,19492.0,372,24,39,11,63,0.31286549707602335
112,swap,19488.0,368,24,39,11,63,0.3090218746458121
113,swap,19488.0,368,24,39,11,63,0.3090218746458121
114,swap,19488.0,368,24,39,11,63,0.3090218746458121
115,swap,19488.0,368,24,39,11,63,0.3090218746458121
116,reassign,18866.0,366,23,38,10,61,0.30656975433851685
117,swap,18866.0,366,23,38,10,61,0.30656975433851685
118,reassign,18863.0,363,22,39,10,61,0.30408915703033346
119,swap,18863.0,363,22,39,10,61,0.30408915703033346
120,swap,18863.0,363,22,39,10,61,0.30408915703033346
121,swap,18863.0,363,22,39,10,61,0.30408915703033346
122,swap,18863.0,363,22,39,10,61,0.30408915703033346
123,swap,18863.0,363,22,39,10,61,0.30408915703033346
124,swap,18863.0,363,22,39,10,61,0.30408915703033346
125,swap,18863.0,363,22,39,10,61,0.30408915703033346
126,mut_micro,18863.0,363,22,39,10,61,0.30408915703033346
127,swap,18863.0,363,22,39,10,61,0.30408915703033346
128,swap,18863.0,363,22,39,10,61,0.30408915703033346
129,swap,18568.0,368,22,38,10,60,0.3128754391930183
130,mut_micro,18568.0,368,22,38,10,60,0.3128754391930183
131,mut_micro,18568.0,368,22,38,10,60,0.3128754391930183
132,swap,18568.0,368,22,38,10,60,0.3128754391930183
133,swap,18568.0,368,22,38,10,60,0.3128754391930183
134,swap,18568.0,368,22,38,10,60,0.3128754391930183
135,swap,18568.0,368,22,38,10,60,0.3128754391930183
136,swap,18568.0,368,22,38,10,60,0.3128754391930183
137,swap,18568.0,368,22,38,10,60,0.3128754391930183
138,swap,18272.0,372,22,37,10,59,0.31670679967893584
139,swap,18272.0,372,22,37,10,59,0.31670679967893584
140,swap,18272.0,372,22,37,10,59,0.31670679967893584
141,swap,18272.0,372,22,37,10,59,0.31670679967893584
142,swap,18272.0,372,22,37,10,59,0.31670679967893584
143,swap,18272.0,372,22,37,10,59,0.31670679967893584
144,swap,18272.0,372,22,37,10,59,0.31670679967893584
145,swap,18272.0,372,22,37,10,59,0.31670679967893584
146,swap,18272.0,372,22,37,10,59,0.31670679967893584
147,swap,18272.0,372,22,37,10,59,0.31670679967893584
148,swap,18272.0,372,22,37,10,59,0.31670679967893584
149,swap,18271.0,371,22,37,10,59,0.31586920482478703
150,swap,18270.0,370,22,37,10,59,0.31714546283629735
151,swap,18270.0,370,22,37,10,59,0.31714546283629735
152,swap,18270.0,370,22,37,10,59,0.31714546283629735
153,swap,18270.0,370,22,37,10,59,0.31714546283629735
154,swap,18270.0,370,22,37,10,59,0.31714546283629735
155,mut_micro,18270.0,370,22,37,10,59,0.31714546283629735
156,swap,18270.0,370,22,37,10,59,0.31714546283629735
157,swap,18270.0,370,22,37,10,59,0.31714546283629735
158,swap,17972.0,372,22,36,10,58,0.32089209952987036
159,swap,17972.0,372,22,36,10,58,0.32089209952987036
160,swap,17672.0,372,22,35,10,57,0.32089209952987036
161,swap,17672.0,372,22,35,10,57,0.32089209952987036
162,swap,17672.0,372,22,35,10,57,0.32089209952987036
163,reassign,17670.0,370,22,35,10,57,0.31714546283629735
164,swap,17670.0,370,22,35,10,57,0.31714546283629735
165,mut_micro,17374.0,374,21,35,10,56,0.3218569780853518
166,swap,17374.0,374,21,35,10,56,0.3218569780853518
167,swap,17374.0,374,21,35,10,56,0.3218569780853518
168,swap,17374.0,374,21,35,10,56,0.3218569780853518
169,swap,17374.0,374,21,35,10,56,0.3218569780853518
170,swap,17374.0,374,21,35,10,56,0.3218569780853518
171,swap,17374.0,374,21,35,10,56,0.3218569780853518
172,swap,17374.0,374,21,35,10,56,0.3218569780853518
173,swap,17374.0,374,21,35,10,56,0.3218569780853518
174,swap,17374.0,374,21,35,10,56,0.3218569780853518
175,swap,17374.0,374,21,35,10,56,0.3218569780853518
176,swap,17374.0,374,21,35,10,56,0.3218569780853518
177,swap,17374.0,374,21,35,10,56,0.3218569780853518
178,swap,17374.0,374,21,35,10,56,0.3218569780853518
179,swap,17374.0,374,21,35,10,56,0.3218569780853518
180,swap,17374.0,374,21,35,10,56,0.3218569780853518
181,swap,17374.0,374,21,35,10,56,0.3218569780853518
182,swap,17374.0,374,21,35,10,56,0.3218569780853518
183,mut_micro,17374.0,374,21,35,10,56,0.3218569780853518
184,swap,17374.0,374,21,35,10,56,0.3218569780853518
185,swap,17374.0,374,21,35,10,56,0.3218569780853518
186,reassign,17374.0,374,21,35,10,56,0.3218569780853518
187,swap,17374.0,374,21,35,10,56,0.3218569780853518
188,swap,17083.0,383,21,34,10,55,0.3299863752147385
189,swap,17083.0,383,21,34,10,55,0.3299863752147385
190,swap,17083.0,383,21,34,10,55,0.3299863752147385
191,swap,16786.0,386,21,33,10,54,0.33440937350549976
192,swap,16786.0,386,21,33,10,54,0.33440937350549976
193,swap,16786.0,386,21,33,10,54,0.33440937350549976
194,swap,16786.0,386,21,33,10,54,0.33440937350549976
195,swap,16786.0,386,21,33,10,54,0.33440937350549976
196,swap,16786.0,386,21,33,10,54,0.33440937350549976
197,swap,16786.0,386,21,33,10,54,0.33440937350549976
198,swap,16786.0,386,21,33,10,54,0.33440937350549976
199,reassign,16786.0,386,21,33,10,54,0.33440937350549976
200,swap,16786.0,386,21,33,10,54,0.33440937350549976
201,swap,16786.0,386,21,33,10,54,0.33440937350549976
202,swap,16786.0,386,21,33,10,54,0.33440937350549976
203,swap,16786.0,386,21,33,10,54,0.33440937350549976
204,swap,16786.0,386,21,33,10,54,0.33440937350549976
205,reassign,16786.0,386,21,33,10,54,0.33440937350549976
206,swap,16488.0,388,21,32,10,53,0.3350775893179357
207,swap,16488.0,388,21,32,10,53,0.3350775893179357
208,swap,16488.0,388,21,32,10,53,0.3350775893179357
209,swap,16488.0,388,21,32,10,53,0.3350775893179357
210,reassign,16190.0,390,20,32,10,52,0.3372670055676592
211,reassign,16190.0,390,20,32,10,52,0.3372670055676592
212,reassign,16190.0,390,20,32,10,52,0.3372670055676592
213,reassign,16190.0,390,20,32,10,52,0.3372670055676592
214,reassign,16190.0,390,20,32,10,52,0.3372670055676592
215,reassign,16190.0,390,20,32,10,52,0.3372670055676592
216,swap,16190.0,390,20,32,10,52,0.3372670055676592
217,swap,16190.0,390,20,32,10,52,0.3372670055676592
218,swap,16184.0,384,20,32,10,52,0.3332144979203802
219,swap,16184.0,384,20,32,10,52,0.3332144979203802
220,swap,16184.0,384,20,32,10,52,0.3332144979203802
221,swap,16184.0,384,20,32,10,52,0.3332144979203802
222,swap,16184.0,384,20,32,10,52,0.3332144979203802
223,swap,16184.0,384,20,32,10,52,0.3332144979203802
224,swap,16184.0,384,20,32,10,52,0.3332144979203802
225,swap,16184.0,384,20,32,10,52,0.3332144979203802
226,swap,16184.0,384,20,32,10,52,0.3332144979203802
227,swap,16184.0,384,20,32,10,52,0.3332144979203802
228,swap,16184.0,384,20,32,10,52,0.3332144979203802
229,swap,16184.0,384,20,32,10,52,0.3332144979203802
230,mut_micro,16184.0,384,20,32,10,52,0.3332144979203802
231,swap,16182.0,382,20,32,10,52,0.33091188282541933
232,swap,15890.0,390,20,31,10,51,0.33641975308641986
233,swap,15890.0,390,20,31,10,51,0.33641975308641986
234,reassign,15890.0,390,20,31,10,51,0.33641975308641986
235,swap,15890.0,390,20,31,10,51,0.33641975308641986
236,swap,15890.0,390,20,31,10,51,0.33641975308641986
237,swap,15890.0,390,20,31,10,51,0.33641975308641986
238,swap,15890.0,390,20,31,10,51,0.33641975308641986
239,swap,15598.0,398,20,30,10,50,0.34369570613055345
240,mut_micro,15598.0,398,20,30,10,50,0.34369570613055345
241,swap,15598.0,398,20,30,10,50,0.34369570613055345
242,swap,15598.0,398,20,30,10,50,0.34369570613055345
243,swap,15598.0,398,20,30,10,50,0.34369570613055345
244,swap,15598.0,398,20,30,10,50,0.34369570613055345
245,swap,15598.0,398,20,30,10,50,0.34369570613055345
246,swap,15597.0,397,20,30,10,50,0.3422712933753944
247,swap,15597.0,397,20,30,10,50,0.3422712933753944
248,swap,15597.0,397,20,30,10,50,0.3422712933753944
249,swap,15597.0,397,20,30,10,50,0.3422712933753944
250,swap,15597.0,397,20,30,10,50,0.3422712933753944
251,swap,15597.0,397,20,30,10,50,0.3422712933753944
252,swap,15597.0,397,20,30,10,50,0.3422712933753944
253,swap,15597.0,397,20,30,10,50,0.3422712933753944
254,swap,15597.0,397,20,30,10,50,0.3422712933753944
255,swap,15597.0,397,20,30,10,50,0.3422712933753944
256,swap,15597.0,397,20,30,10,50,0.3422712933753944
257,swap,15597.0,397,20,30,10,50,0.3422712933753944
258,swap,15597.0,397,20,30,10,50,0.3422712933753944
259,swap,15597.0,397,20,30,10,50,0.3422712933753944
260,swap,15597.0,397,20,30,10,50,0.3422712933753944
261,swap,15597.0,397,20,30,10,50,0.3422712933753944
262,swap,15303.0,403,20,29,10,49,0.3503877435218461
263,swap,15303.0,403,20,29,10,49,0.3503877435218461
264,mut_micro,15303.0,403,20,29,10,49,0.3503877435218461
265,swap,15301.0,401,20,29,10,49,0.351531666979891
266,swap,15301.0,401,20,29,10,49,0.351531666979891
267,swap,15301.0,401,20,29,10,49,0.351531666979891
268,swap,15301.0,401,20,29,10,49,0.351531666979891
269,swap,15301.0,401,20,29,10,49,0.351531666979891
270,swap,15301.0,401,20,29,10,49,0.351531666979891
271,swap,15301.0,401,20,29,10,49,0.351531666979891
272,swap,15301.0,401,20,29,10,49,0.351531666979891
273,swap,15301.0,401,20,29,10,49,0.351531666979891
274,swap,15301.0,401,20,29,10,49,0.351531666979891
275,swap,15301.0,401,20,29,10,49,0.351531666979891
276,swap,15301.0,401,20,29,10,49,0.351531666979891
277,swap,15301.0,401,20,29,10,49,0.351531666979891
278,reassign,15003.0,403,19,29,10,48,0.3503877435218461
279,swap,15001.0,401,19,29,10,48,0.3499655453235608
280,swap,15001.0,401,19,29,10,48,0.3499655453235608
281,swap,15001.0,401,19,29,10,48,0.3499655453235608
282,swap,15001.0,401,19,29,10,48,0.3499655453235608
283,swap,15001.0,401,19,29,10,48,0.3499655453235608
284,swap,15001.0,401,19,29,10,48,0.3499655453235608
285,swap,15001.0,401,19,29,10,48,0.3499655453235608
286,swap,15001.0,401,19,29,10,48,0.3499655453235608
287,swap,15001.0,401,19,29,10,48,0.3499655453235608
288,swap,15001.0,401,19,29,10,48,0.3499655453235608
289,swap,15001.0,401,19,29,10,48,0.3499655453235608
290,reassign,15001.0,401,19,29,10,48,0.3499655453235608
291,swap,15001.0,401,19,29,10,48,0.3499655453235608
292,reassign,15001.0,401,19,29,10,48,0.3499655453235608
293,reassign,15001.0,401,19,29,10,48,0.3499655453235608
294,reassign,15001.0,401,19,29,10,48,0.3499655453235608
295,reassign,15001.0,401,19,29,10,48,0.3499655453235608
296,reassign,14658.0,398,18,29,8,47,0.3480392156862745
297,reassign,14658.0,398,18,29,8,47,0.3480392156862745
298,reassign,14658.0,398,18,29,8,47,0.3480392156862745
299,reassign,14658.0,398,18,29,8,47,0.3480392156862745
300,reassign,14616.0,396,17,30,6,47,0.349056603773585
301,reassign,14616.0,396,17,30,6,47,0.349056603773585
302,reassign,14616.0,396,17,30,6,47,0.349056603773585
303,reassign,14616.0,396,17,30,6,47,0.349056603773585
304,swap,14616.0,396,17,30,6,47,0.349056603773585
305,swap,14616.0,396,17,30,6,47,0.349056603773585
306,reassign,14616.0,396,17,30,6,47,0.349056603773585
307,reassign,14616.0,396,17,30,6,47,0.349056603773585
308,swap,14616.0,396,17,30,6,47,0.349056603773585
309,reassign,14616.0,396,17,30,6,47,0.349056603773585
310,swap,14616.0,396,17,30,6,47,0.349056603773585
311,swap,14616.0,396,17,30,6,47,0.349056603773585
312,mut_micro,14616.0,396,17,30,6,47,0.349056603773585
313,swap,14616.0,396,17,30,6,47,0.349056603773585
314,swap,14616.0,396,17,30,6,47,0.349056603773585
315,swap,14616.0,396,17,30,6,47,0.349056603773585
316,reassign,14593.0,393,17,30,5,47,0.3449697636063772
317,reassign,14593.0,393,17,30,5,47,0.3449697636063772
318,reassign,14589.0,389,18,29,5,47,0.3407843137254901
319,reassign,14589.0,389,18,29,5,47,0.3407843137254901
320,reassign,14589.0,389,18,29,5,47,0.3407843137254901
321,reassign,14291.0,391,18,28,5,46,0.341498209190797
322,reassign,14291.0,391,18,28,5,46,0.341498209190797
323,reassign,14291.0,391,18,28,5,46,0.341498209190797
324,reassign,14291.0,391,18,28,5,46,0.341498209190797
325,reassign,14291.0,391,18,28,5,46,0.341498209190797
326,reassign,13990.0,390,17,28,5,45,0.3394456548051319
327,reassign,13990.0,390,17,28,5,45,0.3394456548051319
328,reassign,13990.0,390,17,28,5,45,0.3394456548051319
329,reassign,13990.0,390,17,28,5,45,0.3394456548051319
330,mut_micro,13990.0,390,17,28,5,45,0.3394456548051319
331,mut_micro,13990.0,390,17,28,5,45,0.3394456548051319
332,mut_micro,13685.0,385,16,28,5,44,0.33610465462780853
333,mut_micro,13685.0,385,16,28,5,44,0.33610465462780853
334,mut_micro,13685.0,385,16,28,5,44,0.33610465462780853
335,mut_micro,13685.0,385,16,28,5,44,0.33610465462780853
336,mut_micro,13685.0,385,16,28,5,44,0.33610465462780853
337,reassign,13685.0,385,16,28,5,44,0.33610465462780853
338,mut_micro,13685.0,385,16,28,5,44,0.33610465462780853
339,swap,13685.0,385,16,28,5,44,0.33610465462780853
340,reassign,13685.0,385,16,28,5,44,0.33610465462780853
341,reassign,13685.0,385,16,28,5,44,0.33610465462780853
342,reassign,13086.0,386,15,27,5,42,0.33608321377331424
343,reassign,13086.0,386,15,27,5,42,0.33608321377331424
344,reassign,12788.0,388,14,27,5,41,0.33964874293275593
345,reassign,12788.0,388,14,27,5,41,0.33964874293275593
346,reassign,12788.0,388,14,27,5,41,0.33964874293275593
347,reassign,12466.0,386,12,28,4,40,0.33889287422285985
348,reassign,12466.0,386,12,28,4,40,0.33889287422285985
349,reassign,12466.0,386,12,28,4,40,0.33889287422285985
350,reassign,12466.0,386,12,28,4,40,0.33889287422285985
351,reassign,12466.0,386,12,28,4,40,0.33889287422285985
352,reassign,12466.0,386,12,28,4,40,0.33889287422285985
353,swap,12466.0,386,12,28,4,40,0.33889287422285985
354,swap,12175.0,395,12,27,4,39,0.3463335177331121
355,swap,11883.0,403,12,26,4,38,0.35328793896980015
356,swap,11883.0,403,12,26,4,38,0.35328793896980015
357,swap,11584.0,404,12,25,4,37,0.3552182163187856
358,swap,11584.0,404,12,25,4,37,0.3552182163187856
359,swap,11584.0,404,12,25,4,37,0.3552182163187856
360,swap,11584.0,404,12,25,4,37,0.3552182163187856
361,swap,11584.0,404,12,25,4,37,0.3552182163187856
362,swap,11584.0,404,12,25,4,37,0.3552182163187856
363,swap,11584.0,404,12,25,4,37,0.3552182163187856
364,swap,11584.0,404,12,25,4,37,0.3552182163187856
365,swap,11584.0,404,12,25,4,37,0.3552182163187856
366,swap,11584.0,404,12,25,4,37,0.3552182163187856
367,swap,11584.0,404,12,25,4,37,0.3552182163187856
368,swap,11584.0,404,12,25,4,37,0.3552182163187856
369,swap,11584.0,404,12,25,4,37,0.3552182163187856
370,swap,11584.0,404,12,25,4,37,0.3552182163187856
371,swap,11584.0,404,12,25,4,37,0.3552182163187856
372,swap,11287.0,407,12,24,4,36,0.3590406846777799
373,swap,11287.0,407,12,24,4,36,0.3590406846777799
374,swap,11287.0,407,12,24,4,36,0.3590406846777799
375,swap,11287.0,407,12,24,4,36,0.3590406846777799
376,swap,11287.0,407,12,24,4,36,0.3590406846777799
377,swap,11287.0,407,12,24,4,36,0.3590406846777799
378,swap,11287.0,407,12,24,4,36,0.3590406846777799
379,reassign,11287.0,407,12,24,4,36,0.3590406846777799
380,reassign,11287.0,407,12,24,4,36,0.3590406846777799
381,reassign,11287.0,407,12,24,4,36,0.3590406846777799
382,swap,11287.0,407,12,24,4,36,0.3590406846777799
383,swap,11287.0,407,12,24,4,36,0.3590406846777799
384,swap,11287.0,407,12,24,4,36,0.3590406846777799
385,swap,11287.0,407,12,24,4,36,0.3590406846777799
386,swap,11287.0,407,12,24,4,36,0.3590406846777799
387,swap,11287.0,407,12,24,4,36,0.3590406846777799
388,swap,11287.0,407,12,24,4,36,0.3590406846777799
389,swap,11287.0,407,12,24,4,36,0.3590406846777799
390,swap,11287.0,407,12,24,4,36,0.3590406846777799
391,swap,11287.0,407,12,24,4,36,0.3590406846777799
392,swap,11287.0,407,12,24,4,36,0.3590406846777799
393,swap,11287.0,407,12,24,4,36,0.3590406846777799
394,swap,11287.0,407,12,24,4,36,0.3590406846777799
395,swap,11287.0,407,12,24,4,36,0.3590406846777799
396,swap,11287.0,407,12,24,4,36,0.3590406846777799
397,swap,11287.0,407,12,24,4,36,0.3590406846777799
398,swap,11287.0,407,12,24,4,36,0.3590406846777799
399,swap,11287.0,407,12,24,4,36,0.3590406846777799
400,swap,11287.0,407,12,24,4,36,0.3590406846777799
401,swap,11287.0,407,12,24,4,36,0.3590406846777799
402,swap,11287.0,407,12,24,4,36,0.3590406846777799
403,swap,11287.0,407,12,24,4,36,0.3590406846777799
404,swap,11287.0,407,12,24,4,36,0.3590406846777799
405,swap,11287.0,407,12,24,4,36,0.3590406846777799
406,swap,11287.0,407,12,24,4,36,0.3590406846777799
407,swap,11287.0,407,12,24,4,36,0.3590406846777799
408,swap,11287.0,407,12,24,4,36,0.3590406846777799
409,swap,11287.0,407,12,24,4,36,0.3590406846777799
410,swap,11287.0,407,12,24,4,36,0.3590406846777799
411,swap,11287.0,407,12,24,4,36,0.3590406846777799
412,swap,11287.0,407,12,24,4,36,0.3590406846777799
413,swap,10992.0,412,12,23,4,35,0.361576418646929
414,swap,10992.0,412,12,23,4,35,0.361576418646929
415,swap,10992.0,412,12,23,4,35,0.361576418646929
416,swap,10992.0,412,12,23,4,35,0.361576418646929
417,swap,10696.0,416,12,22,4,34,0.36498223450454015
418,swap,10696.0,416,12,22,4,34,0.36498223450454015
419,swap,10696.0,416,12,22,4,34,0.36498223450454015
420,swap,10696.0,416,12,22,4,34,0.36498223450454015
421,swap,10696.0,416,12,22,4,34,0.36498223450454015
422,swap,10696.0,416,12,22,4,34,0.36498223450454015
423,swap,10400.0,420,12,21,4,33,0.3652794451113779
424,swap,10400.0,420,12,21,4,33,0.3652794451113779
425,swap,10400.0,420,12,21,4,33,0.3652794451113779
426,mut_micro,10400.0,420,12,21,4,33,0.3652794451113779
427,swap,10400.0,420,12,21,4,33,0.3652794451113779
428,reassign,10400.0,420,12,21,4,33,0.3652794451113779
429,swap,10400.0,420,12,21,4,33,0.3652794451113779
430,swap,10400.0,420,12,21,4,33,0.3652794451113779
431,swap,10400.0,420,12,21,4,33,0.3652794451113779
432,swap,10400.0,420,12,21,4,33,0.3652794451113779
433,swap,10400.0,420,12,21,4,33,0.3652794451113779
434,swap,10400.0,420,12,21,4,33,0.3652794451113779
435,swap,10400.0,420,12,21,4,33,0.3652794451113779
436,swap,10400.0,420,12,21,4,33,0.3652794451113779
437,swap,10400.0,420,12,21,4,33,0.3652794451113779
438,swap,10400.0,420,12,21,4,33,0.3652794451113779
439,swap,10400.0,420,12,21,4,33,0.3652794451113779
440,swap,10400.0,420,12,21,4,33,0.3652794451113779
441,mut_micro,10400.0,420,12,21,4,33,0.3652794451113779
442,swap,10400.0,420,12,21,4,33,0.3652794451113779
443,swap,10400.0,420,12,21,4,33,0.3652794451113779
444,swap,10400.0,420,12,21,4,33,0.3652794451113779
445,swap,10400.0,420,12,21,4,33,0.3652794451113779
446,reassign,10400.0,420,12,21,4,33,0.3652794451113779
447,swap,10400.0,420,12,21,4,33,0.3652794451113779
448,swap,10398.0,418,12,21,4,33,0.3650635930047694
449,swap,10398.0,418,12,21,4,33,0.3650635930047694
450,swap,10398.0,418,12,21,4,33,0.3650635930047694
451,swap,10398.0,418,12,21,4,33,0.3650635930047694
452,swap,10398.0,418,12,21,4,33,0.3650635930047694
453,swap,10398.0,418,12,21,4,33,0.3650635930047694
454,swap,10398.0,418,12,21,4,33,0.3650635930047694
455,swap,10398.0,418,12,21,4,33,0.3650635930047694
456,swap,10398.0,418,12,21,4,33,0.3650635930047694
457,swap,10398.0,418,12,21,4,33,0.3650635930047694
458,swap,10398.0,418,12,21,4,33,0.3650635930047694
459,swap,10398.0,418,12,21,4,33,0.3650635930047694
460,swap,10398.0,418,12,21,4,33,0.3650635930047694
461,swap,10398.0,418,12,21,4,33,0.3650635930047694
462,swap,10398.0,418,12,21,4,33,0.3650635930047694
463,swap,10398.0,418,12,21,4,33,0.3650635930047694
464,swap,10398.0,418,12,21,4,33,0.3650635930047694
465,swap,10398.0,418,12,21,4,33,0.3650635930047694
466,swap,10398.0,418,12,21,4,33,0.3650635930047694
467,swap,10398.0,418,12,21,4,33,0.3650635930047694
468,swap,10398.0,418,12,21,4,33,0.3650635930047694
469,swap,10398.0,418,12,21,4,33,0.3650635930047694
470,swap,10398.0,418,12,21,4,33,0.3650635930047694
471,swap,10398.0,418,12,21,4,33,0.3650635930047694
472,swap,10398.0,418,12,21,4,33,0.3650635930047694
473,swap,10398.0,418,12,21,4,33,0.3650635930047694
474,swap,10398.0,418,12,21,4,33,0.3650635930047694
475,reassign,10398.0,418,12,21,4,33,0.3650635930047694
476,swap,10396.0,416,12,21,4,33,0.3633372812212133
477,swap,10396.0,416,12,21,4,33,0.3633372812212133
478,swap,10396.0,416,12,21,4,33,0.3633372812212133
479,swap,10396.0,416,12,21,4,33,0.3633372812212133
480,swap,10396.0,416,12,21,4,33,0.3633372812212133
481,swap,10396.0,416,12,21,4,33,0.3633372812212133
482,swap,10396.0,416,12,21,4,33,0.3633372812212133
483,swap,10396.0,416,12,21,4,33,0.3633372812212133
484,swap,10396.0,416,12,21,4,33,0.3633372812212133
485,swap,10396.0,416,12,21,4,33,0.3633372812212133
486,reassign,10393.0,413,13,20,4,33,0.3596834082470197
487,swap,10390.0,410,13,20,4,33,0.3603586171310629
488,swap,10390.0,410,13,20,4,33,0.3603586171310629
489,swap,10097.0,417,13,19,4,32,0.36307519640852975
490,swap,10097.0,417,13,19,4,32,0.36307519640852975
491,swap,10097.0,417,13,19,4,32,0.36307519640852975
492,swap,10097.0,417,13,19,4,32,0.36307519640852975
493,swap,10097.0,417,13,19,4,32,0.36307519640852975
494,swap,10097.0,417,13,19,4,32,0.36307519640852975
495,swap,10095.0,415,13,19,4,32,0.36123680241327305
496,swap,10095.0,415,13,19,4,32,0.36123680241327305
497,swap,10095.0,415,13,19,4,32,0.36123680241327305
498,swap,10095.0,415,13,19,4,32,0.36123680241327305
499,swap,10095.0,415,13,19,4,32,0.36123680241327305
500,swap,10095.0,415,13,19,4,32,0.36123680241327305
501,swap,10095.0,415,13,19,4,32,0.36123680241327305
502,swap,10095.0,415,13,19,4,32,0.36123680241327305
503,swap,10095.0,415,13,19,4,32,0.36123680241327305
504,swap,10095.0,415,13,19,4,32,0.36123680241327305
505,mut_micro,9751.0,411,12,19,2,31,0.3577622468129167
506,swap,9751.0,411,12,19,2,31,0.3577622468129167
507,swap,9751.0,411,12,19,2,31,0.3577622468129167
508,swap,9751.0,411,12,19,2,31,0.3577622468129167
509,swap,9751.0,411,12,19,2,31,0.3577622468129167
510,swap,9751.0,411,12,19,2,31,0.3577622468129167
511,swap,9751.0,411,12,19,2,31,0.3577622468129167
512,swap,9751.0,411,12,19,2,31,0.3577622468129167
513,swap,9751.0,411,12,19,2,31,0.3577622468129167
514,swap,9751.0,411,12,19,2,31,0.3577622468129167
515,swap,9751.0,411,12,19,2,31,0.3577622468129167
516,swap,9751.0,411,12,19,2,31,0.3577622468129167
517,swap,9751.0,411,12,19,2,31,0.3577622468129167
518,swap,9751.0,411,12,19,2,31,0.3577622468129167
519,swap,9751.0,411,12,19,2,31,0.3577622468129167
520,swap,9751.0,411,12,19,2,31,0.3577622468129167
521,swap,9751.0,411,12,19,2,31,0.3577622468129167
522,swap,9751.0,411,12,19,2,31,0.3577622468129167
523,swap,9751.0,411,12,19,2,31,0.3577622468129167
524,swap,9751.0,411,12,19,2,31,0.3577622468129167
525,swap,9751.0,411,12,19,2,31,0.3577622468129167
526,swap,9751.0,411,12,19,2,31,0.3577622468129167
527,swap,9751.0,411,12,19,2,31,0.3577622468129167
528,swap,9751.0,411,12,19,2,31,0.3577622468129167
529,swap,9751.0,411,12,19,2,31,0.3577622468129167
530,swap,9751.0,411,12,19,2,31,0.3577622468129167
531,swap,9751.0,411,12,19,2,31,0.3577622468129167
532,swap,9751.0,411,12,19,2,31,0.3577622468129167
533,swap,9751.0,411,12,19,2,31,0.3577622468129167
534,swap,9751.0,411,12,19,2,31,0.3577622468129167
535,swap,9751.0,411,12,19,2,31,0.3577622468129167
536,swap,9751.0,411,12,19,2,31,0.3577622468129167
537,swap,9751.0,411,12,19,2,31,0.3577622468129167
538,swap,9751.0,411,12,19,2,31,0.3577622468129167
539,swap,9456.0,416,12,18,2,30,0.3645216475852086
540,swap,9456.0,416,12,18,2,30,0.3645216475852086
541,swap,9456.0,416,12,18,2,30,0.3645216475852086
542,swap,9456.0,416,12,18,2,30,0.3645216475852086
543,swap,9456.0,416,12,18,2,30,0.3645216475852086
544,swap,9456.0,416,12,18,2,30,0.3645216475852086
545,swap,9456.0,416,12,18,2,30,0.3645216475852086
546,swap,9456.0,416,12,18,2,30,0.3645216475852086
547,swap,9456.0,416,12,18,2,30,0.3645216475852086
548,swap,9456.0,416,12,18,2,30,0.3645216475852086
549,swap,9456.0,416,12,18,2,30,0.3645216475852086
550,reassign,9456.0,416,12,18,2,30,0.3645216475852086
551,swap,9456.0,416,12,18,2,30,0.3645216475852086
552,swap,9456.0,416,12,18,2,30,0.3645216475852086
553,swap,9456.0,416,12,18,2,30,0.3645216475852086
554,swap,9456.0,416,12,18,2,30,0.3645216475852086
555,swap,9160.0,420,12,17,2,29,0.36781379218354004
556,swap,9160.0,420,12,17,2,29,0.36781379218354004
557,swap,9160.0,420,12,17,2,29,0.36781379218354004
558,swap,9160.0,420,12,17,2,29,0.36781379218354004
559,swap,9160.0,420,12,17,2,29,0.36781379218354004
560,swap,9160.0,420,12,17,2,29,0.36781379218354004
561,swap,9160.0,420,12,17,2,29,0.36781379218354004
562,swap,9160.0,420,12,17,2,29,0.36781379218354004
563,swap,9160.0,420,12,17,2,29,0.36781379218354004
564,swap,9160.0,420,12,17,2,29,0.36781379218354004
565,swap,9160.0,420,12,17,2,29,0.36781379218354004
566,swap,9160.0,420,12,17,2,29,0.36781379218354004
567,swap,9160.0,420,12,17,2,29,0.36781379218354004
568,swap,9160.0,420,12,17,2,29,0.36781379218354004
569,swap,9160.0,420,12,17,2,29,0.36781379218354004
570,swap,9160.0,420,12,17,2,29,0.36781379218354004
571,swap,9160.0,420,12,17,2,29,0.36781379218354004
572,swap,9160.0,420,12,17,2,29,0.36781379218354004
573,swap,9160.0,420,12,17,2,29,0.36781379218354004
574,swap,9160.0,420,12,17,2,29,0.36781379218354004
575,swap,9160.0,420,12,17,2,29,0.36781379218354004
576,swap,9160.0,420,12,17,2,29,0.36781379218354004
577,swap,9160.0,420,12,17,2,29,0.36781379218354004
578,swap,9158.0,418,12,17,2,29,0.36917064122946475
579,swap,9158.0,418,12,17,2,29,0.36917064122946475
580,swap,9158.0,418,12,17,2,29,0.36917064122946475
581,swap,9158.0,418,12,17,2,29,0.36917064122946475
582,swap,9158.0,418,12,17,2,29,0.36917064122946475
583,swap,9158.0,418,12,17,2,29,0.36917064122946475
584,swap,9158.0,418,12,17,2,29,0.36917064122946475
585,swap,9158.0,418,12,17,2,29,0.36917064122946475
586,swap,9158.0,418,12,17,2,29,0.36917064122946475
587,mut_micro,9158.0,418,12,17,2,29,0.36917064122946475
588,swap,9158.0,418,12,17,2,29,0.36917064122946475
589,swap,9158.0,418,12,17,2,29,0.36917064122946475
590,swap,9154.0,414,12,17,2,29,0.3658169934640523
591,swap,9154.0,414,12,17,2,29,0.3658169934640523
592,swap,9154.0,414,12,17,2,29,0.3658169934640523
593,swap,9154.0,414,12,17,2,29,0.3658169934640523
594,swap,9154.0,414,12,17,2,29,0.3658169934640523
595,reassign,9154.0,414,12,17,2,29,0.3658169934640523
596,swap,9154.0,414,12,17,2,29,0.3658169934640523
597,swap,9154.0,414,12,17,2,29,0.3658169934640523
598,swap,9154.0,414,12,17,2,29,0.3658169934640523
599,swap,9154.0,414,12,17,2,29,0.3658169934640523
600,swap,9154.0,414,12,17,2,29,0.3658169934640523
601,swap,8862.0,422,12,16,2,28,0.37234756916465217
602,swap,8862.0,422,12,16,2,28,0.37234756916465217
603,swap,8862.0,422,12,16,2,28,0.37234756916465217
604,mut_micro,8560.0,420,11,16,2,27,0.36948112578364695
605,swap,8560.0,420,11,16,2,27,0.36948112578364695
606,swap,8559.0,419,11,16,2,27,0.3705217680292456
607,swap,8558.0,418,11,16,2,27,0.3693031266560677
608,swap,8558.0,418,11,16,2,27,0.3693031266560677
609,swap,8558.0,418,11,16,2,27,0.3693031266560677
610,swap,8558.0,418,11,16,2,27,0.3693031266560677
611,mut_micro,8558.0,418,11,16,2,27,0.3693031266560677
612,swap,8554.0,414,11,16,2,27,0.3660130718954248
613,swap,8554.0,414,11,16,2,27,0.3660130718954248
614,swap,8554.0,414,11,16,2,27,0.3660130718954248
615,swap,8554.0,414,11,16,2,27,0.3660130718954248
616,swap,8554.0,414,11,16,2,27,0.3660130718954248
617,swap,8554.0,414,11,16,2,27,0.3660130718954248
618,swap,8554.0,414,11,16,2,27,0.3660130718954248
619,swap,8554.0,414,11,16,2,27,0.3660130718954248
620,swap,8554.0,414,11,16,2,27,0.3660130718954248
621,swap,8554.0,414,11,16,2,27,0.3660130718954248
622,swap,8554.0,414,11,16,2,27,0.3660130718954248
623,swap,8259.0,419,11,15,2,26,0.36826188102359586
624,swap,8259.0,419,11,15,2,26,0.36826188102359586
625,swap,8259.0,419,11,15,2,26,0.36826188102359586
626,swap,8259.0,419,11,15,2,26,0.36826188102359586
627,swap,8259.0,419,11,15,2,26,0.36826188102359586
628,swap,8259.0,419,11,15,2,26,0.36826188102359586
629,swap,8259.0,419,11,15,2,26,0.36826188102359586
630,swap,8259.0,419,11,15,2,26,0.36826188102359586
631,swap,8259.0,419,11,15,2,26,0.36826188102359586
632,swap,8259.0,419,11,15,2,26,0.36826188102359586
633,swap,8259.0,419,11,15,2,26,0.36826188102359586
634,swap,8257.0,417,11,15,2,26,0.36644219977553305
635,swap,8257.0,417,11,15,2,26,0.36644219977553305
636,reassign,7975.0,415,12,13,3,25,0.3677290314118959
637,swap,7975.0,415,12,13,3,25,0.3677290314118959
638,swap,7975.0,415,12,13,3,25,0.3677290314118959
639,swap,7975.0,415,12,13,3,25,0.3677290314118959
640,swap,7975.0,415,12,13,3,25,0.3677290314118959
641,swap,7975.0,415,12,13,3,25,0.3677290314118959
642,swap,7975.0,415,12,13,3,25,0.3677290314118959
643,swap,7975.0,415,12,13,3,25,0.3677290314118959
644,swap,7975.0,415,12,13,3,25,0.3677290314118959
645,swap,7975.0,415,12,13,3,25,0.3677290314118959
646,mut_micro,7974.0,414,12,13,3,25,0.36640522875816994
647,swap,7974.0,414,12,13,3,25,0.36640522875816994
648,swap,7974.0,414,12,13,3,25,0.36640522875816994
649,swap,7684.0,424,12,12,3,24,0.37065584854631506
650,swap,7684.0,424,12,12,3,24,0.37065584854631506
651,swap,7684.0,424,12,12,3,24,0.37065584854631506
652,swap,7684.0,424,12,12,3,24,0.37065584854631506
653,reassign,7683.0,423,12,12,3,24,0.36901152213462696
654,swap,7683.0,423,12,12,3,24,0.36901152213462696
655,swap,7683.0,423,12,12,3,24,0.36901152213462696
656,swap,7683.0,423,12,12,3,24,0.36901152213462696
657,swap,7683.0,423,12,12,3,24,0.36901152213462696
658,swap,7683.0,423,12,12,3,24,0.36901152213462696
659,swap,7683.0,423,12,12,3,24,0.36901152213462696
660,swap,7683.0,423,12,12,3,24,0.36901152213462696
661,reassign,7683.0,423,12,12,3,24,0.36901152213462696
662,swap,7683.0,423,12,12,3,24,0.36901152213462696
663,swap,7683.0,423,12,12,3,24,0.36901152213462696
664,swap,7683.0,423,12,12,3,24,0.36901152213462696
665,mut_micro,7683.0,423,12,12,3,24,0.36901152213462696
666,swap,7683.0,423,12,12,3,24,0.36901152213462696
667,swap,7683.0,423,12,12,3,24,0.36901152213462696
668,swap,7683.0,423,12,12,3,24,0.36901152213462696
669,mut_micro,7382.0,422,11,12,3,23,0.3677142089712597
670,swap,7382.0,422,11,12,3,23,0.3677142089712597
671,reassign,7382.0,422,11,12,3,23,0.3677142089712597
672,swap,7382.0,422,11,12,3,23,0.3677142089712597
673,swap,7382.0,422,11,12,3,23,0.3677142089712597
674,swap,7382.0,422,11,12,3,23,0.3677142089712597
675,swap,7382.0,422,11,12,3,23,0.3677142089712597
676,swap,7382.0,422,11,12,3,23,0.3677142089712597
677,swap,7382.0,422,11,12,3,23,0.3677142089712597
678,mut_micro,7382.0,422,11,12,3,23,0.3677142089712597
679,swap,7382.0,422,11,12,3,23,0.3677142089712597
680,swap,7382.0,422,11,12,3,23,0.3677142089712597
681,swap,7382.0,422,11,12,3,23,0.3677142089712597
682,swap,7382.0,422,11,12,3,23,0.3677142089712597
683,swap,7382.0,422,11,12,3,23,0.3677142089712597
684,swap,7382.0,422,11,12,3,23,0.3677142089712597
685,swap,7382.0,422,11,12,3,23,0.3677142089712597
686,swap,7382.0,422,11,12,3,23,0.3677142089712597
687,swap,7382.0,422,11,12,3,23,0.3677142089712597
688,swap,7382.0,422,11,12,3,23,0.3677142089712597
689,swap,7382.0,422,11,12,3,23,0.3677142089712597
690,swap,7382.0,422,11,12,3,23,0.3677142089712597
691,swap,7382.0,422,11,12,3,23,0.3677142089712597
692,swap,7382.0,422,11,12,3,23,0.3677142089712597
693,swap,7382.0,422,11,12,3,23,0.3677142089712597
694,swap,7382.0,422,11,12,3,23,0.3677142089712597
695,swap,7382.0,422,11,12,3,23,0.3677142089712597
696,swap,7382.0,422,11,12,3,23,0.3677142089712597
697,swap,7382.0,422,11,12,3,23,0.3677142089712597
698,swap,7382.0,422,11,12,3,23,0.3677142089712597
699,swap,7082.0,422,11,11,3,22,0.3677142089712597
700,reassign,7082.0,422,11,11,3,22,0.3677142089712597
701,swap,7082.0,422,11,11,3,22,0.3677142089712597
702,swap,6790.0,430,11,10,3,21,0.3727561447114055
703,swap,6790.0,430,11,10,3,21,0.3727561447114055
704,swap,6790.0,430,11,10,3,21,0.3727561447114055
705,swap,6790.0,430,11,10,3,21,0.3727561447114055
706,swap,6790.0,430,11,10,3,21,0.3727561447114055
707,swap,6790.0,430,11,10,3,21,0.3727561447114055
708,swap,6790.0,430,11,10,3,21,0.3727561447114055
709,swap,6790.0,430,11,10,3,21,0.3727561447114055
710,swap,6499.0,439,11,9,3,20,0.3765775401069518
711,swap,6499.0,439,11,9,3,20,0.3765775401069518
712,swap,6499.0,439,11,9,3,20,0.3765775401069518
713,swap,6499.0,439,11,9,3,20,0.3765775401069518
714,swap,6499.0,439,11,9,3,20,0.3765775401069518
715,swap,6499.0,439,11,9,3,20,0.3765775401069518
716,swap,6499.0,439,11,9,3,20,0.3765775401069518
717,swap,6499.0,439,11,9,3,20,0.3765775401069518
718,swap,6499.0,439,11,9,3,20,0.3765775401069518
719,swap,6499.0,439,11,9,3,20,0.3765775401069518
720,swap,6496.0,436,11,9,3,20,0.3743828466638454
721,swap,6496.0,436,11,9,3,20,0.3743828466638454
722,mut_micro,6496.0,436,11,9,3,20,0.3743828466638454
723,swap,6496.0,436,11,9,3,20,0.3743828466638454
724,swap,6496.0,436,11,9,3,20,0.3743828466638454
725,swap,6496.0,436,11,9,3,20,0.3743828466638454
726,swap,6496.0,436,11,9,3,20,0.3743828466638454
727,swap,6496.0,436,11,9,3,20,0.3743828466638454
728,swap,6496.0,436,11,9,3,20,0.3743828466638454
729,swap,6493.0,433,11,9,3,20,0.37132789058683957
730,swap,6493.0,433,11,9,3,20,0.37132789058683957
731,swap,6492.0,432,11,9,3,20,0.3710193297177027
732,swap,6492.0,432,11,9,3,20,0.3710193297177027
733,swap,6492.0,432,11,9,3,20,0.3710193297177027
734,swap,6492.0,432,11,9,3,20,0.3710193297177027
735,swap,6492.0,432,11,9,3,20,0.3710193297177027
736,swap,6492.0,432,11,9,3,20,0.3710193297177027
737,swap,6492.0,432,11,9,3,20,0.3710193297177027
738,swap,6492.0,432,11,9,3,20,0.3710193297177027
739,swap,6492.0,432,11,9,3,20,0.3710193297177027
740,swap,6492.0,432,11,9,3,20,0.3710193297177027
741,swap,6492.0,432,11,9,3,20,0.3710193297177027
742,swap,6492.0,432,11,9,3,20,0.3710193297177027
743,swap,6492.0,432,11,9,3,20,0.3710193297177027
744,swap,6492.0,432,11,9,3,20,0.3710193297177027
745,swap,6492.0,432,11,9,3,20,0.3710193297177027
746,swap,6492.0,432,11,9,3,20,0.3710193297177027
747,swap,6492.0,432,11,9,3,20,0.3710193297177027
748,swap,6492.0,432,11,9,3,20,0.3710193297177027
749,swap,6492.0,432,11,9,3,20,0.3710193297177027
750,swap,6488.0,428,11,9,3,20,0.36822980940628
751,swap,6488.0,428,11,9,3,20,0.36822980940628
752,swap,6488.0,428,11,9,3,20,0.36822980940628
753,swap,6488.0,428,11,9,3,20,0.36822980940628
754,mut_micro,6488.0,428,11,9,3,20,0.36822980940628
755,swap,6488.0,428,11,9,3,20,0.36822980940628
756,swap,6488.0,428,11,9,3,20,0.36822980940628
757,mut_micro,6488.0,428,11,9,3,20,0.36822980940628
758,swap,6488.0,428,11,9,3,20,0.36822980940628
759,swap,6488.0,428,11,9,3,20,0.36822980940628
760,swap,6488.0,428,11,9,3,20,0.36822980940628
761,swap,6488.0,428,11,9,3,20,0.36822980940628
762,swap,6488.0,428,11,9,3,20,0.36822980940628
763,swap,6488.0,428,11,9,3,20,0.36822980940628
764,swap,6488.0,428,11,9,3,20,0.36822980940628
765,swap,6488.0,428,11,9,3,20,0.36822980940628
766,mut_micro,6488.0,428,11,9,3,20,0.36822980940628
767,swap,6488.0,428,11,9,3,20,0.36822980940628
768,swap,6488.0,428,11,9,3,20,0.36822980940628
769,swap,6488.0,428,11,9,3,20,0.36822980940628
770,swap,6488.0,428,11,9,3,20,0.36822980940628
771,reassign,6488.0,428,11,9,3,20,0.36822980940628
772,swap,6488.0,428,11,9,3,20,0.36822980940628
773,swap,6488.0,428,11,9,3,20,0.36822980940628
774,swap,6488.0,428,11,9,3,20,0.36822980940628
775,swap,6488.0,428,11,9,3,20,0.36822980940628
776,swap,6488.0,428,11,9,3,20,0.36822980940628
777,swap,6488.0,428,11,9,3,20,0.36822980940628
778,swap,6488.0,428,11,9,3,20,0.36822980940628
779,swap,6488.0,428,11,9,3,20,0.36822980940628
780,swap,6488.0,428,11,9,3,20,0.36822980940628
781,swap,6488.0,428,11,9,3,20,0.36822980940628
782,swap,6488.0,428,11,9,3,20,0.36822980940628
783,reassign,6488.0,428,11,9,3,20,0.36822980940628
784,swap,6488.0,428,11,9,3,20,0.36822980940628
785,swap,6488.0,428,11,9,3,20,0.36822980940628
786,mut_micro,6488.0,428,11,9,3,20,0.36822980940628
787,swap,6488.0,428,11,9,3,20,0.36822980940628
788,swap,6488.0,428,11,9,3,20,0.36822980940628
789,reassign,6488.0,428,11,9,3,20,0.36822980940628
790,swap,6488.0,428,11,9,3,20,0.36822980940628
791,swap,6488.0,428,11,9,3,20,0.36822980940628
792,swap,6488.0,428,11,9,3,20,0.36822980940628
793,swap,6488.0,428,11,9,3,20,0.36822980940628
794,swap,6488.0,428,11,9,3,20,0.36822980940628
795,swap,6488.0,428,11,9,3,20,0.36822980940628
796,swap,6488.0,428,11,9,3,20,0.36822980940628
797,mut_micro,6192.0,432,11,8,3,19,0.36802948129606444
798,swap,6192.0,432,11,8,3,19,0.36802948129606444
799,swap,6192.0,432,11,8,3,19,0.36802948129606444
800,reassign,6192.0,432,11,8,3,19,0.36802948129606444
801,swap,6192.0,432,11,8,3,19,0.36802948129606444
802,swap,6192.0,432,11,8,3,19,0.36802948129606444
803,swap,6192.0,432,11,8,3,19,0.36802948129606444
804,swap,6192.0,432,11,8,3,19,0.36802948129606444
805,swap,6192.0,432,11,8,3,19,0.36802948129606444
806,swap,6192.0,432,11,8,3,19,0.36802948129606444
807,swap,6192.0,432,11,8,3,19,0.36802948129606444
808,swap,6192.0,432,11,8,3,19,0.36802948129606444
809,swap,6192.0,432,11,8,3,19,0.36802948129606444
810,swap,6192.0,432,11,8,3,19,0.36802948129606444
811,swap,6192.0,432,11,8,3,19,0.36802948129606444
812,swap,6192.0,432,11,8,3,19,0.36802948129606444
813,swap,6192.0,432,11,8,3,19,0.36802948129606444
814,swap,6190.0,430,11,8,3,19,0.3681303507318419
815,swap,6185.0,425,11,8,3,19,0.3665445416921093
816,swap,6185.0,425,11,8,3,19,0.3665445416921093
817,swap,6185.0,425,11,8,3,19,0.3665445416921093
818,swap,6185.0,425,11,8,3,19,0.3665445416921093
819,swap,6185.0,425,11,8,3,19,0.3665445416921093
820,swap,6185.0,425,11,8,3,19,0.3665445416921093
821,swap,6185.0,425,11,8,3,19,0.3665445416921093
822,swap,6185.0,425,11,8,3,19,0.3665445416921093
823,swap,6185.0,425,11,8,3,19,0.3665445416921093
824,swap,6185.0,425,11,8,3,19,0.3665445416921093
825,swap,6185.0,425,11,8,3,19,0.3665445416921093
826,swap,6185.0,425,11,8,3,19,0.3665445416921093
827,swap,6185.0,425,11,8,3,19,0.3665445416921093
828,swap,6185.0,425,11,8,3,19,0.3665445416921093
829,swap,6185.0,425,11,8,3,19,0.3665445416921093
830,swap,6185.0,425,11,8,3,19,0.3665445416921093
831,swap,6185.0,425,11,8,3,19,0.3665445416921093
832,swap,6185.0,425,11,8,3,19,0.3665445416921093
833,swap,6185.0,425,11,8,3,19,0.3665445416921093
834,swap,6185.0,425,11,8,3,19,0.3665445416921093
835,swap,6185.0,425,11,8,3,19,0.3665445416921093
836,swap,6185.0,425,11,8,3,19,0.3665445416921093
837,swap,6185.0,425,11,8,3,19,0.3665445416921093
838,swap,6185.0,425,11,8,3,19,0.3665445416921093
839,mut_micro,6185.0,425,11,8,3,19,0.3665445416921093
840,swap,6185.0,425,11,8,3,19,0.3665445416921093
841,swap,6185.0,425,11,8,3,19,0.3665445416921093
842,swap,6185.0,425,11,8,3,19,0.3665445416921093
843,swap,6185.0,425,11,8,3,19,0.3665445416921093
844,reassign,6185.0,425,11,8,3,19,0.3665445416921093
845,reassign,6185.0,425,11,8,3,19,0.3665445416921093
846,reassign,6185.0,425,11,8,3,19,0.3665445416921093
847,reassign,6185.0,425,11,8,3,19,0.3665445416921093
848,reassign,6184.0,424,11,8,3,19,0.36484110885733595
849,reassign,6183.0,423,11,8,3,19,0.3630820025604743
850,mut_micro,6183.0,423,11,8,3,19,0.3630820025604743
851,reassign,6183.0,423,11,8,3,19,0.3630820025604743
852,reassign,6183.0,423,11,8,3,19,0.3630820025604743
853,swap,6183.0,423,11,8,3,19,0.3630820025604743
854,swap,6183.0,423,11,8,3,19,0.3630820025604743
855,swap,6183.0,423,11,8,3,19,0.3630820025604743
856,swap,6183.0,423,11,8,3,19,0.3630820025604743
857,swap,6183.0,423,11,8,3,19,0.3630820025604743
858,swap,6183.0,423,11,8,3,19,0.3630820025604743
859,reassign,6183.0,423,11,8,3,19,0.3630820025604743
860,mut_micro,6183.0,423,11,8,3,19,0.3630820025604743
861,mut_micro,6183.0,423,11,8,3,19,0.3630820025604743
862,mut_micro,6183.0,423,11,8,3,19,0.3630820025604743
863,swap,6183.0,423,11,8,3,19,0.3630820025604743
864,mut_micro,6183.0,423,11,8,3,19,0.3630820025604743
865,reassign,6183.0,423,11,8,3,19,0.3630820025604743
866,mut_micro,6183.0,423,11,8,3,19,0.3630820025604743
867,mut_micro,6183.0,423,11,8,3,19,0.3630820025604743
868,swap,6183.0,423,11,8,3,19,0.3630820025604743
869,swap,6183.0,423,11,8,3,19,0.3630820025604743
870,reassign,6183.0,423,11,8,3,19,0.3630820025604743
871,swap,6183.0,423,11,8,3,19,0.3630820025604743
872,swap,6183.0,423,11,8,3,19,0.3630820025604743
873,swap,6183.0,423,11,8,3,19,0.3630820025604743
874,swap,6183.0,423,11,8,3,19,0.3630820025604743
875,swap,6183.0,423,11,8,3,19,0.3630820025604743
876,swap,6183.0,423,11,8,3,19,0.3630820025604743
877,swap,6183.0,423,11,8,3,19,0.3630820025604743
878,swap,6183.0,423,11,8,3,19,0.3630820025604743
879,swap,6183.0,423,11,8,3,19,0.3630820025604743
880,swap,6183.0,423,11,8,3,19,0.3630820025604743
881,swap,6183.0,423,11,8,3,19,0.3630820025604743
882,swap,6183.0,423,11,8,3,19,0.3630820025604743
883,swap,6183.0,423,11,8,3,19,0.3630820025604743
884,swap,6183.0,423,11,8,3,19,0.3630820025604743
885,swap,6183.0,423,11,8,3,19,0.3630820025604743
886,swap,6183.0,423,11,8,3,19,0.3630820025604743
887,swap,6183.0,423,11,8,3,19,0.3630820025604743
888,swap,6183.0,423,11,8,3,19,0.3630820025604743
889,swap,6183.0,423,11,8,3,19,0.3630820025604743
890,mut_micro,6183.0,423,11,8,3,19,0.3630820025604743
891,swap,6183.0,423,11,8,3,19,0.3630820025604743
892,swap,6183.0,423,11,8,3,19,0.3630820025604743
893,swap,6183.0,423,11,8,3,19,0.3630820025604743
894,swap,6183.0,423,11,8,3,19,0.3630820025604743
895,swap,6183.0,423,11,8,3,19,0.3630820025604743
896,swap,6183.0,423,11,8,3,19,0.3630820025604743
897,swap,6182.0,422,11,8,3,19,0.36126779478914856
898,reassign,6182.0,422,11,8,3,19,0.36126779478914856
899,swap,6182.0,422,11,8,3,19,0.36126779478914856
900,swap,6182.0,422,11,8,3,19,0.36126779478914856
901,swap,6182.0,422,11,8,3,19,0.36126779478914856
902,swap,6182.0,422,11,8,3,19,0.36126779478914856
903,swap,6182.0,422,11,8,3,19,0.36126779478914856
904,swap,6177.0,417,11,8,3,19,0.35931207499834955
905,reassign,6177.0,417,11,8,3,19,0.35931207499834955
906,swap,6177.0,417,11,8,3,19,0.35931207499834955
907,swap,6177.0,417,11,8,3,19,0.35931207499834955
908,swap,6177.0,417,11,8,3,19,0.35931207499834955
909,swap,6177.0,417,11,8,3,19,0.35931207499834955
910,mut_micro,6177.0,417,11,8,3,19,0.35931207499834955
911,swap,6177.0,417,11,8,3,19,0.35931207499834955
912,reassign,5876.0,416,10,8,3,18,0.3574154494012369
913,swap,5876.0,416,10,8,3,18,0.3574154494012369
914,mut_micro,5876.0,416,10,8,3,18,0.3574154494012369
915,mut_micro,5876.0,416,10,8,3,18,0.3574154494012369
916,swap,5876.0,416,10,8,3,18,0.3574154494012369
917,swap,5876.0,416,10,8,3,18,0.3574154494012369
918,swap,5876.0,416,10,8,3,18,0.3574154494012369
919,swap,5876.0,416,10,8,3,18,0.3574154494012369
920,swap,5876.0,416,10,8,3,18,0.3574154494012369
921,swap,5876.0,416,10,8,3,18,0.3574154494012369
922,swap,5876.0,416,10,8,3,18,0.3574154494012369
923,swap,5876.0,416,10,8,3,18,0.3574154494012369
924,swap,5876.0,416,10,8,3,18,0.3574154494012369
925,swap,5876.0,416,10,8,3,18,0.3574154494012369
926,swap,5876.0,416,10,8,3,18,0.3574154494012369
927,swap,5876.0,416,10,8,3,18,0.3574154494012369
928,swap,5876.0,416,10,8,3,18,0.3574154494012369
929,mut_micro,5855.0,415,10,8,2,18,0.355465932192275
930,swap,5855.0,415,10,8,2,18,0.355465932192275
931,swap,5855.0,415,10,8,2,18,0.355465932192275
932,swap,5855.0,415,10,8,2,18,0.355465932192275
933,swap,5855.0,415,10,8,2,18,0.355465932192275
934,swap,5855.0,415,10,8,2,18,0.355465932192275
935,swap,5855.0,415,10,8,2,18,0.355465932192275
936,swap,5855.0,415,10,8,2,18,0.355465932192275
937,swap,5855.0,415,10,8,2,18,0.355465932192275
938,swap,5855.0,415,10,8,2,18,0.355465932192275
939,swap,5855.0,415,10,8,2,18,0.355465932192275
940,swap,5855.0,415,10,8,2,18,0.355465932192275
941,swap,5855.0,415,10,8,2,18,0.355465932192275
942,swap,5855.0,415,10,8,2,18,0.355465932192275
943,swap,5855.0,415,10,8,2,18,0.355465932192275
944,swap,5855.0,415,10,8,2,18,0.355465932192275
945,swap,5855.0,415,10,8,2,18,0.355465932192275
946,swap,5855.0,415,10,8,2,18,0.355465932192275
947,swap,5855.0,415,10,8,2,18,0.355465932192275
948,swap,5855.0,415,10,8,2,18,0.355465932192275
949,swap,5855.0,415,10,8,2,18,0.355465932192275
950,swap,5855.0,415,10,8,2,18,0.355465932192275
951,swap,5855.0,415,10,8,2,18,0.355465932192275
952,swap,5855.0,415,10,8,2,18,0.355465932192275
953,swap,5855.0,415,10,8,2,18,0.355465932192275
954,swap,5855.0,415,10,8,2,18,0.355465932192275
955,swap,5855.0,415,10,8,2,18,0.355465932192275
956,swap,5855.0,415,10,8,2,18,0.355465932192275
957,swap,5855.0,415,10,8,2,18,0.355465932192275
958,swap,5855.0,415,10,8,2,18,0.355465932192275
959,swap,5855.0,415,10,8,2,18,0.355465932192275
960,swap,5853.0,413,10,8,2,18,0.3569474301348447
961,swap,5853.0,413,10,8,2,18,0.3569474301348447
962,swap,5853.0,413,10,8,2,18,0.3569474301348447
963,swap,5853.0,413,10,8,2,18,0.3569474301348447
964,swap,5853.0,413,10,8,2,18,0.3569474301348447
965,swap,5853.0,413,10,8,2,18,0.3569474301348447
966,swap,5853.0,413,10,8,2,18,0.3569474301348447
967,swap,5853.0,413,10,8,2,18,0.3569474301348447
968,swap,5853.0,413,10,8,2,18,0.3569474301348447
969,swap,5853.0,413,10,8,2,18,0.3569474301348447
970,swap,5853.0,413,10,8,2,18,0.3569474301348447
971,swap,5853.0,413,10,8,2,18,0.3569474301348447
972,swap,5853.0,413,10,8,2,18,0.3569474301348447
973,swap,5853.0,413,10,8,2,18,0.3569474301348447
974,swap,5853.0,413,10,8,2,18,0.3569474301348447
975,swap,5853.0,413,10,8,2,18,0.3569474301348447
976,reassign,5853.0,413,10,8,2,18,0.3569474301348447
977,swap,5853.0,413,10,8,2,18,0.3569474301348447
978,swap,5853.0,413,10,8,2,18,0.3569474301348447
979,swap,5853.0,413,10,8,2,18,0.3569474301348447
980,swap,5853.0,413,10,8,2,18,0.3569474301348447
981,swap,5853.0,413,10,8,2,18,0.3569474301348447
982,swap,5853.0,413,10,8,2,18,0.3569474301348447
983,swap,5853.0,413,10,8,2,18,0.3569474301348447
984,swap,5853.0,413,10,8,2,18,0.3569474301348447
985,swap,5853.0,413,10,8,2,18,0.3569474301348447
986,swap,5853.0,413,10,8,2,18,0.3569474301348447
987,swap,5853.0,413,10,8,2,18,0.3569474301348447
988,swap,5853.0,413,10,8,2,18,0.3569474301348447
989,swap,5853.0,413,10,8,2,18,0.3569474301348447
990,swap,5853.0,413,10,8,2,18,0.3569474301348447
991,swap,5853.0,413,10,8,2,18,0.3569474301348447
992,swap,5853.0,413,10,8,2,18,0.3569474301348447
993,swap,5853.0,413,10,8,2,18,0.3569474301348447
994,swap,5853.0,413,10,8,2,18,0.3569474301348447
995,swap,5853.0,413,10,8,2,18,0.3569474301348447
996,swap,5853.0,413,10,8,2,18,0.3569474301348447
997,swap,5853.0,413,10,8,2,18,0.3569474301348447
998,swap,5853.0,413,10,8,2,18,0.3569474301348447
999,swap,5853.0,413,10,8,2,18,0.3569474301348447
1000,swap,5853.0,413,10,8,2,18,0.3569474301348447
