iter,op,fitness_score,pref_penalty,capacity_viol,elig_viol,under_cap,total_violations,gini
1,swap,30354.0,354,42,57,15,99,0.2724400871459695
2,swap,30057.0,357,42,56,15,98,0.2794254956884714
3,swap,29764.0,364,42,55,15,97,0.2894117647058825
4,swap,29764.0,364,42,55,15,97,0.2894117647058825
5,swap,29764.0,364,42,55,15,97,0.2894117647058825
6,swap,29764.0,364,42,55,15,97,0.2894117647058825
7,swap,29764.0,364,42,55,15,97,0.2894117647058825
8,swap,29764.0,364,42,55,15,97,0.2894117647058825
9,reassign,29461.0,361,41,55,15,96,0.28436927178803534
10,swap,29461.0,361,41,55,15,96,0.28436927178803534
11,reassign,29165.0,365,39,56,15,95,0.2892016405416036
12,reassign,29165.0,365,39,56,15,95,0.2892016405416036
13,mut_micro,29165.0,365,39,56,15,95,0.2892016405416036
14,reassign,29165.0,365,39,56,15,95,0.2892016405416036
15,swap,29165.0,365,39,56,15,95,0.2892016405416036
16,swap,28872.0,372,39,55,15,94,0.29704162366701076
17,swap,28872.0,372,39,55,15,94,0.29704162366701076
18,swap,28573.0,373,39,54,15,93,0.29949399114484515
19,swap,28279.0,379,39,53,15,92,0.30907228563067035
20,swap,28279.0,379,39,53,15,92,0.30907228563067035
21,swap,28279.0,379,39,53,15,92,0.30907228563067035
22,swap,28279.0,379,39,53,15,92,0.30907228563067035
23,swap,28279.0,379,39,53,15,92,0.30907228563067035
24,mut_micro,27679.0,379,37,53,15,90,0.30907228563067035
25,mut_micro,27381.0,381,36,53,15,89,0.3131072248719308
26,mut_micro,27082.0,382,36,52,15,88,0.3128395936687928
27,mut_micro,27082.0,382,36,52,15,88,0.3128395936687928
28,mut_micro,27082.0,382,36,52,15,88,0.3128395936687928
29,swap,27082.0,382,36,52,15,88,0.3128395936687928
30,swap,27082.0,382,36,52,15,88,0.3128395936687928
31,swap,27082.0,382,36,52,15,88,0.3128395936687928
32,swap,27082.0,382,36,52,15,88,0.3128395936687928
33,mut_micro,26444.0,384,34,52,13,86,0.3113487819370173
34,mut_micro,26444.0,384,34,52,13,86,0.3113487819370173
35,mut_micro,26444.0,384,34,52,13,86,0.3113487819370173
36,reassign,26426.0,386,34,52,12,86,0.3115734098517456
37,swap,26425.0,385,34,52,12,86,0.3119673401275403
38,swap,26425.0,385,34,52,12,86,0.3119673401275403
39,reassign,26083.0,383,33,52,10,85,0.31345891831052664
40,swap,26083.0,383,33,52,10,85,0.31345891831052664
41,mut_micro,25819.0,379,34,50,12,84,0.31252560725782863
42,mut_micro,25503.0,383,34,49,11,83,0.31345891831052664
43,mut_micro,25480.0,380,34,49,10,83,0.3114359516261595
44,mut_micro,24882.0,382,32,49,10,81,0.31543822348216405
45,swap,24882.0,382,32,49,10,81,0.31543822348216405
46,mut_micro,24582.0,382,30,50,10,80,0.31543822348216405
47,mut_micro,23678.0,378,29,48,10,77,0.31098272642390296
48,mut_micro,23676.0,376,30,47,10,77,0.31041884209305026
49,mut_micro,23676.0,376,30,47,10,77,0.31041884209305026
50,mut_micro,23676.0,376,30,47,10,77,0.31041884209305026
51,mut_micro,23676.0,376,30,47,10,77,0.31041884209305026
52,mut_micro,23675.0,375,29,48,10,77,0.31051535658511187
53,mut_micro,23374.0,374,29,47,10,76,0.3105536332179932
54,mut_micro,23078.0,378,27,48,10,75,0.3117413632119515
55,mut_micro,23078.0,378,27,48,10,75,0.3117413632119515
56,mut_micro,23059.0,379,26,49,9,75,0.31334503950834075
57,mut_micro,22460.0,380,26,47,9,73,0.3121404250322884
58,mut_micro,22460.0,380,26,47,9,73,0.3121404250322884
59,swap,22165.0,385,26,46,9,72,0.31536444364980026
60,mut_micro,21569.0,389,26,44,9,70,0.31604826546003
61,mut_micro,21567.0,387,26,44,9,70,0.31555435629909456
62,mut_micro,21567.0,387,26,44,9,70,0.31555435629909456
63,mut_micro,21567.0,387,26,44,9,70,0.31555435629909456
64,mut_micro,21567.0,387,26,44,9,70,0.31555435629909456
65,mut_micro,21563.0,383,25,45,9,70,0.31108939043895495
66,mut_micro,21245.0,385,24,45,8,69,0.31327850289051784
67,mut_micro,21245.0,385,24,45,8,69,0.31327850289051784
68,mut_micro,21245.0,385,24,45,8,69,0.31327850289051784
69,mut_micro,20946.0,386,23,45,8,68,0.3131874701099953
70,mut_micro,20946.0,386,23,45,8,68,0.3131874701099953
71,mut_micro,20647.0,387,22,45,8,67,0.31303591773100675
72,mut_micro,20647.0,387,22,45,8,67,0.31303591773100675
73,mut_micro,20647.0,387,22,45,8,67,0.31303591773100675
74,mut_micro,20647.0,387,22,45,8,67,0.31303591773100675
75,mut_micro,20647.0,387,22,45,8,67,0.31303591773100675
76,mut_micro,20647.0,387,22,45,8,67,0.31303591773100675
77,swap,20647.0,387,22,45,8,67,0.31303591773100675
78,swap,20647.0,387,22,45,8,67,0.31303591773100675
79,swap,20647.0,387,22,45,8,67,0.31303591773100675
80,mut_micro,20647.0,387,22,45,8,67,0.31303591773100675
81,swap,20351.0,391,22,44,8,66,0.31988708796211973
82,swap,20351.0,391,22,44,8,66,0.31988708796211973
83,swap,20351.0,391,22,44,8,66,0.31988708796211973
84,mut_micro,20351.0,391,22,44,8,66,0.31988708796211973
85,swap,20351.0,391,22,44,8,66,0.31988708796211973
86,swap,20351.0,391,22,44,8,66,0.31988708796211973
87,swap,20351.0,391,22,44,8,66,0.31988708796211973
88,swap,20351.0,391,22,44,8,66,0.31988708796211973
89,mut_micro,20351.0,391,22,44,8,66,0.31988708796211973
90,swap,20351.0,391,22,44,8,66,0.31988708796211973
91,swap,20351.0,391,22,44,8,66,0.31988708796211973
92,swap,20351.0,391,22,44,8,66,0.31988708796211973
93,swap,20351.0,391,22,44,8,66,0.31988708796211973
94,swap,20057.0,397,22,43,8,65,0.32779736500278356
95,mut_micro,20056.0,396,22,43,8,65,0.32636576643235915
96,swap,20056.0,396,22,43,8,65,0.32636576643235915
97,swap,20056.0,396,22,43,8,65,0.32636576643235915
98,swap,20056.0,396,22,43,8,65,0.32636576643235915
99,swap,20056.0,396,22,43,8,65,0.32636576643235915
100,swap,20053.0,393,22,43,8,65,0.3220023211776922
101,swap,20053.0,393,22,43,8,65,0.3220023211776922
102,swap,20053.0,393,22,43,8,65,0.3220023211776922
103,reassign,20053.0,393,22,43,8,65,0.3220023211776922
104,swap,20053.0,393,22,43,8,65,0.3220023211776922
105,swap,20053.0,393,22,43,8,65,0.3220023211776922
106,swap,20053.0,393,22,43,8,65,0.3220023211776922
107,mut_micro,20048.0,388,22,43,8,65,0.31907855166606514
108,mut_micro,20048.0,388,22,43,8,65,0.31907855166606514
109,swap,20048.0,388,22,43,8,65,0.31907855166606514
110,swap,20044.0,384,22,43,8,65,0.31824123588829467
111,swap,20044.0,384,22,43,8,65,0.31824123588829467
112,swap,20044.0,384,22,43,8,65,0.31824123588829467
113,swap,20044.0,384,22,43,8,65,0.31824123588829467
114,swap,20044.0,384,22,43,8,65,0.31824123588829467
115,swap,20044.0,384,22,43,8,65,0.31824123588829467
116,reassign,20044.0,384,22,43,8,65,0.31824123588829467
117,swap,20044.0,384,22,43,8,65,0.31824123588829467
118,swap,19750.0,390,22,42,8,64,0.32637375938029534
119,swap,19750.0,390,22,42,8,64,0.32637375938029534
120,swap,19750.0,390,22,42,8,64,0.32637375938029534
121,mut_micro,19750.0,390,22,42,8,64,0.32637375938029534
122,mut_micro,19750.0,390,22,42,8,64,0.32637375938029534
123,mut_micro,19709.0,389,22,42,6,64,0.32413273001508297
124,mut_micro,19709.0,389,22,42,6,64,0.32413273001508297
125,swap,19709.0,389,22,42,6,64,0.32413273001508297
126,mut_micro,19709.0,389,22,42,6,64,0.32413273001508297
127,swap,19705.0,385,22,42,6,64,0.32323142022766543
128,swap,19705.0,385,22,42,6,64,0.32323142022766543
129,swap,19705.0,385,22,42,6,64,0.32323142022766543
130,swap,19705.0,385,22,42,6,64,0.32323142022766543
131,mut_micro,19702.0,382,22,42,6,64,0.32364753130167734
132,mut_micro,19702.0,382,22,42,6,64,0.32364753130167734
133,mut_micro,19702.0,382,22,42,6,64,0.32364753130167734
134,mut_micro,19379.0,379,21,42,5,63,0.3190810652619257
135,mut_micro,19379.0,379,21,42,5,63,0.3190810652619257
136,mut_micro,19360.0,380,21,42,4,63,0.3198896324997064
137,mut_micro,19360.0,380,21,42,4,63,0.3198896324997064
138,swap,19360.0,380,21,42,4,63,0.3198896324997064
139,swap,19360.0,380,21,42,4,63,0.3198896324997064
140,swap,19360.0,380,21,42,4,63,0.3198896324997064
141,swap,19360.0,380,21,42,4,63,0.3198896324997064
142,reassign,19360.0,380,21,42,4,63,0.3198896324997064
143,swap,19360.0,380,21,42,4,63,0.3198896324997064
144,swap,19360.0,380,21,42,4,63,0.3198896324997064
145,swap,19360.0,380,21,42,4,63,0.3198896324997064
146,swap,19360.0,380,21,42,4,63,0.3198896324997064
147,swap,19360.0,380,21,42,4,63,0.3198896324997064
148,swap,19360.0,380,21,42,4,63,0.3198896324997064
149,reassign,19360.0,380,21,42,4,63,0.3198896324997064
150,swap,19360.0,380,21,42,4,63,0.3198896324997064
151,swap,19360.0,380,21,42,4,63,0.3198896324997064
152,swap,19360.0,380,21,42,4,63,0.3198896324997064
153,swap,19360.0,380,21,42,4,63,0.3198896324997064
154,swap,19359.0,379,21,42,4,63,0.3190810652619257
155,swap,19359.0,379,21,42,4,63,0.3190810652619257
156,swap,19359.0,379,21,42,4,63,0.3190810652619257
157,swap,19359.0,379,21,42,4,63,0.3190810652619257
158,swap,19359.0,379,21,42,4,63,0.3190810652619257
159,swap,19359.0,379,21,42,4,63,0.3190810652619257
160,mut_micro,18456.0,376,19,41,4,60,0.3192945817380208
161,reassign,18456.0,376,19,41,4,60,0.3192945817380208
162,mut_micro,18137.0,377,18,41,3,59,0.31928201547681384
163,mut_micro,17532.0,372,18,39,3,57,0.31561747506019955
164,mut_micro,17532.0,372,18,39,3,57,0.31561747506019955
165,swap,17532.0,372,18,39,3,57,0.31561747506019955
166,mut_micro,17532.0,372,18,39,3,57,0.31561747506019955
167,mut_micro,17233.0,373,18,38,3,56,0.31714680006900114
168,reassign,17233.0,373,18,38,3,56,0.31714680006900114
169,mut_micro,16935.0,375,18,37,3,55,0.3195384348429637
170,mut_micro,16935.0,375,18,37,3,55,0.3195384348429637
171,mut_micro,16935.0,375,18,37,3,55,0.3195384348429637
172,mut_micro,16637.0,377,17,37,3,54,0.32184208995170777
173,mut_micro,16636.0,376,17,37,3,54,0.3203967977723634
174,mut_micro,16636.0,376,17,37,3,54,0.3203967977723634
175,mut_micro,16636.0,376,17,37,3,54,0.3203967977723634
176,mut_micro,16636.0,376,17,37,3,54,0.3203967977723634
177,swap,16636.0,376,17,37,3,54,0.3203967977723634
178,swap,16636.0,376,17,37,3,54,0.3203967977723634
179,swap,16636.0,376,17,37,3,54,0.3203967977723634
180,mut_micro,16636.0,376,17,37,3,54,0.3203967977723634
181,swap,16636.0,376,17,37,3,54,0.3203967977723634
182,swap,16335.0,375,17,36,3,53,0.32029035803111805
183,mut_micro,16335.0,375,17,36,3,53,0.32029035803111805
184,swap,16335.0,375,17,36,3,53,0.32029035803111805
185,swap,16335.0,375,17,36,3,53,0.32029035803111805
186,swap,16335.0,375,17,36,3,53,0.32029035803111805
187,swap,16335.0,375,17,36,3,53,0.32029035803111805
188,swap,16335.0,375,17,36,3,53,0.32029035803111805
189,reassign,16335.0,375,17,36,3,53,0.32029035803111805
190,swap,16335.0,375,17,36,3,53,0.32029035803111805
191,swap,16044.0,384,17,35,3,52,0.3283422459893048
192,swap,16044.0,384,17,35,3,52,0.3283422459893048
193,swap,16044.0,384,17,35,3,52,0.3283422459893048
194,swap,16044.0,384,17,35,3,52,0.3283422459893048
195,swap,16044.0,384,17,35,3,52,0.3283422459893048
196,swap,16044.0,384,17,35,3,52,0.3283422459893048
197,mut_micro,16044.0,384,17,35,3,52,0.3283422459893048
198,swap,16044.0,384,17,35,3,52,0.3283422459893048
199,swap,16044.0,384,17,35,3,52,0.3283422459893048
200,mut_micro,16044.0,384,17,35,3,52,0.3283422459893048
201,swap,16044.0,384,17,35,3,52,0.3283422459893048
202,swap,16044.0,384,17,35,3,52,0.3283422459893048
203,swap,16044.0,384,17,35,3,52,0.3283422459893048
204,swap,16044.0,384,17,35,3,52,0.3283422459893048
205,mut_micro,16025.0,385,17,35,2,52,0.3297872340425531
206,mut_micro,15727.0,387,16,35,2,51,0.3304850992384722
207,mut_micro,15727.0,387,16,35,2,51,0.3304850992384722
208,mut_micro,15727.0,387,16,35,2,51,0.3304850992384722
209,swap,15727.0,387,16,35,2,51,0.3304850992384722
210,mut_micro,15126.0,386,15,34,2,49,0.3314801530368244
211,mut_micro,15125.0,385,15,34,2,49,0.33240955956850815
212,mut_micro,15125.0,385,15,34,2,49,0.33240955956850815
213,mut_micro,15125.0,385,15,34,2,49,0.33240955956850815
214,mut_micro,15125.0,385,15,34,2,49,0.33240955956850815
215,swap,15125.0,385,15,34,2,49,0.33240955956850815
216,swap,15125.0,385,15,34,2,49,0.33240955956850815
217,swap,15125.0,385,15,34,2,49,0.33240955956850815
218,swap,15125.0,385,15,34,2,49,0.33240955956850815
219,swap,15125.0,385,15,34,2,49,0.33240955956850815
220,swap,15125.0,385,15,34,2,49,0.33240955956850815
221,swap,14830.0,390,15,33,2,48,0.33569353667392876
222,swap,14830.0,390,15,33,2,48,0.33569353667392876
223,swap,14830.0,390,15,33,2,48,0.33569353667392876
224,swap,14830.0,390,15,33,2,48,0.33569353667392876
225,swap,14830.0,390,15,33,2,48,0.33569353667392876
226,swap,14829.0,389,15,33,2,48,0.33426847662141784
227,swap,14829.0,389,15,33,2,48,0.33426847662141784
228,swap,14829.0,389,15,33,2,48,0.33426847662141784
229,swap,14829.0,389,15,33,2,48,0.33426847662141784
230,swap,14829.0,389,15,33,2,48,0.33426847662141784
231,swap,14829.0,389,15,33,2,48,0.33426847662141784
232,swap,14825.0,385,15,33,2,48,0.3276416949758626
233,swap,14825.0,385,15,33,2,48,0.3276416949758626
234,swap,14825.0,385,15,33,2,48,0.3276416949758626
235,swap,14825.0,385,15,33,2,48,0.3276416949758626
236,swap,14825.0,385,15,33,2,48,0.3276416949758626
237,mut_micro,14801.0,381,14,34,1,48,0.3232938821174116
238,swap,14801.0,381,14,34,1,48,0.3232938821174116
239,swap,14801.0,381,14,34,1,48,0.3232938821174116
240,reassign,14206.0,386,14,32,1,46,0.3266379722620755
241,swap,14206.0,386,14,32,1,46,0.3266379722620755
242,swap,14206.0,386,14,32,1,46,0.3266379722620755
243,swap,14206.0,386,14,32,1,46,0.3266379722620755
244,swap,14206.0,386,14,32,1,46,0.3266379722620755
245,reassign,14206.0,386,14,32,1,46,0.3266379722620755
246,swap,13915.0,395,14,31,1,45,0.3338557993730409
247,swap,13915.0,395,14,31,1,45,0.3338557993730409
248,swap,13915.0,395,14,31,1,45,0.3338557993730409
249,swap,13915.0,395,14,31,1,45,0.3338557993730409
250,swap,13915.0,395,14,31,1,45,0.3338557993730409
251,swap,13915.0,395,14,31,1,45,0.3338557993730409
252,swap,13915.0,395,14,31,1,45,0.3338557993730409
253,swap,13915.0,395,14,31,1,45,0.3338557993730409
254,swap,13915.0,395,14,31,1,45,0.3338557993730409
255,swap,13915.0,395,14,31,1,45,0.3338557993730409
256,swap,13915.0,395,14,31,1,45,0.3338557993730409
257,swap,13915.0,395,14,31,1,45,0.3338557993730409
258,swap,13915.0,395,14,31,1,45,0.3338557993730409
259,swap,13915.0,395,14,31,1,45,0.3338557993730409
260,swap,13915.0,395,14,31,1,45,0.3338557993730409
261,swap,13915.0,395,14,31,1,45,0.3338557993730409
262,swap,13915.0,395,14,31,1,45,0.3338557993730409
263,swap,13915.0,395,14,31,1,45,0.3338557993730409
264,swap,13915.0,395,14,31,1,45,0.3338557993730409
265,swap,13915.0,395,14,31,1,45,0.3338557993730409
266,swap,13915.0,395,14,31,1,45,0.3338557993730409
267,swap,13915.0,395,14,31,1,45,0.3338557993730409
268,swap,13915.0,395,14,31,1,45,0.3338557993730409
269,swap,13915.0,395,14,31,1,45,0.3338557993730409
270,swap,13915.0,395,14,31,1,45,0.3338557993730409
271,swap,13915.0,395,14,31,1,45,0.3338557993730409
272,swap,13915.0,395,14,31,1,45,0.3338557993730409
273,swap,13620.0,400,14,30,1,44,0.34163856625452715
274,swap,13620.0,400,14,30,1,44,0.34163856625452715
275,swap,13620.0,400,14,30,1,44,0.34163856625452715
276,swap,13620.0,400,14,30,1,44,0.34163856625452715
277,swap,13620.0,400,14,30,1,44,0.34163856625452715
278,swap,13620.0,400,14,30,1,44,0.34163856625452715
279,swap,13620.0,400,14,30,1,44,0.34163856625452715
280,swap,13620.0,400,14,30,1,44,0.34163856625452715
281,swap,13320.0,400,14,29,1,43,0.34163856625452715
282,swap,13320.0,400,14,29,1,43,0.34163856625452715
283,swap,13320.0,400,14,29,1,43,0.34163856625452715
284,swap,13026.0,406,14,28,1,42,0.34880315762668695
285,swap,13026.0,406,14,28,1,42,0.34880315762668695
286,swap,13026.0,406,14,28,1,42,0.34880315762668695
287,swap,13026.0,406,14,28,1,42,0.34880315762668695
288,swap,13026.0,406,14,28,1,42,0.34880315762668695
289,swap,13026.0,406,14,28,1,42,0.34880315762668695
290,swap,12727.0,407,14,27,1,41,0.3508654276042664
291,swap,12436.0,416,14,26,1,40,0.35662587182524014
292,swap,12436.0,416,14,26,1,40,0.35662587182524014
293,swap,12436.0,416,14,26,1,40,0.35662587182524014
294,swap,12436.0,416,14,26,1,40,0.35662587182524014
295,swap,12436.0,416,14,26,1,40,0.35662587182524014
296,swap,12436.0,416,14,26,1,40,0.35662587182524014
297,swap,12436.0,416,14,26,1,40,0.35662587182524014
298,swap,12436.0,416,14,26,1,40,0.35662587182524014
299,swap,12436.0,416,14,26,1,40,0.35662587182524014
300,swap,12436.0,416,14,26,1,40,0.35662587182524014
301,swap,12436.0,416,14,26,1,40,0.35662587182524014
302,swap,12436.0,416,14,26,1,40,0.35662587182524014
303,swap,12141.0,421,14,25,1,39,0.35859599812621296
304,swap,12141.0,421,14,25,1,39,0.35859599812621296
305,swap,12141.0,421,14,25,1,39,0.35859599812621296
306,swap,11846.0,426,14,24,1,38,0.3602941176470588
307,swap,11846.0,426,14,24,1,38,0.3602941176470588
308,swap,11846.0,426,14,24,1,38,0.3602941176470588
309,swap,11846.0,426,14,24,1,38,0.3602941176470588
310,reassign,11846.0,426,14,24,1,38,0.3602941176470588
311,swap,11846.0,426,14,24,1,38,0.3602941176470588
312,swap,11846.0,426,14,24,1,38,0.3602941176470588
313,swap,11846.0,426,14,24,1,38,0.3602941176470588
314,swap,11846.0,426,14,24,1,38,0.3602941176470588
315,swap,11846.0,426,14,24,1,38,0.3602941176470588
316,swap,11842.0,422,14,24,1,38,0.3573059360730594
317,reassign,11839.0,419,14,24,1,38,0.3536390827517447
318,swap,11839.0,419,14,24,1,38,0.3536390827517447
319,swap,11839.0,419,14,24,1,38,0.3536390827517447
320,swap,11541.0,421,14,23,1,37,0.35678913203506657
321,swap,11541.0,421,14,23,1,37,0.35678913203506657
322,swap,11244.0,424,14,22,1,36,0.3603786342123055
323,reassign,11244.0,424,14,22,1,36,0.3603786342123055
324,swap,11244.0,424,14,22,1,36,0.3603786342123055
325,swap,11244.0,424,14,22,1,36,0.3603786342123055
326,mut_micro,11242.0,422,15,21,1,36,0.3573059360730594
327,swap,11242.0,422,15,21,1,36,0.3573059360730594
328,swap,11242.0,422,15,21,1,36,0.3573059360730594
329,swap,11242.0,422,15,21,1,36,0.3573059360730594
330,swap,11242.0,422,15,21,1,36,0.3573059360730594
331,swap,11242.0,422,15,21,1,36,0.3573059360730594
332,swap,11242.0,422,15,21,1,36,0.3573059360730594
333,swap,11242.0,422,15,21,1,36,0.3573059360730594
334,swap,11242.0,422,15,21,1,36,0.3573059360730594
335,swap,11242.0,422,15,21,1,36,0.3573059360730594
336,swap,11242.0,422,15,21,1,36,0.3573059360730594
337,swap,11240.0,420,15,21,1,36,0.35907696411898093
338,swap,11240.0,420,15,21,1,36,0.35907696411898093
339,swap,11240.0,420,15,21,1,36,0.35907696411898093
340,swap,11240.0,420,15,21,1,36,0.35907696411898093
341,swap,11240.0,420,15,21,1,36,0.35907696411898093
342,mut_micro,11240.0,420,15,21,1,36,0.35907696411898093
343,swap,11240.0,420,15,21,1,36,0.35907696411898093
344,swap,11240.0,420,15,21,1,36,0.35907696411898093
345,swap,11240.0,420,15,21,1,36,0.35907696411898093
346,swap,11240.0,420,15,21,1,36,0.35907696411898093
347,swap,11240.0,420,15,21,1,36,0.35907696411898093
348,swap,11240.0,420,15,21,1,36,0.35907696411898093
349,swap,11237.0,417,15,21,1,36,0.35541691424044375
350,swap,11237.0,417,15,21,1,36,0.35541691424044375
351,swap,11237.0,417,15,21,1,36,0.35541691424044375
352,swap,11237.0,417,15,21,1,36,0.35541691424044375
353,swap,10941.0,421,15,20,1,35,0.36100515291440816
354,swap,10941.0,421,15,20,1,35,0.36100515291440816
355,swap,10941.0,421,15,20,1,35,0.36100515291440816
356,swap,10939.0,419,15,20,1,35,0.35789298770355604
357,mut_micro,10939.0,419,15,20,1,35,0.35789298770355604
358,swap,10939.0,419,15,20,1,35,0.35789298770355604
359,swap,10939.0,419,15,20,1,35,0.35789298770355604
360,swap,10939.0,419,15,20,1,35,0.35789298770355604
361,swap,10939.0,419,15,20,1,35,0.35789298770355604
362,swap,10939.0,419,15,20,1,35,0.35789298770355604
363,swap,10939.0,419,15,20,1,35,0.35789298770355604
364,swap,10939.0,419,15,20,1,35,0.35789298770355604
365,swap,10939.0,419,15,20,1,35,0.35789298770355604
366,swap,10939.0,419,15,20,1,35,0.35789298770355604
367,swap,10939.0,419,15,20,1,35,0.35789298770355604
368,swap,10939.0,419,15,20,1,35,0.35789298770355604
369,swap,10939.0,419,15,20,1,35,0.35789298770355604
370,swap,10939.0,419,15,20,1,35,0.35789298770355604
371,swap,10939.0,419,15,20,1,35,0.35789298770355604
372,swap,10939.0,419,15,20,1,35,0.35789298770355604
373,mut_micro,10939.0,419,15,20,1,35,0.35789298770355604
374,swap,10939.0,419,15,20,1,35,0.35789298770355604
375,swap,10939.0,419,15,20,1,35,0.35789298770355604
376,swap,10939.0,419,15,20,1,35,0.35789298770355604
377,swap,10939.0,419,15,20,1,35,0.35789298770355604
378,swap,10939.0,419,15,20,1,35,0.35789298770355604
379,swap,10939.0,419,15,20,1,35,0.35789298770355604
380,swap,10939.0,419,15,20,1,35,0.35789298770355604
381,swap,10939.0,419,15,20,1,35,0.35789298770355604
382,swap,10939.0,419,15,20,1,35,0.35789298770355604
383,reassign,10939.0,419,15,20,1,35,0.35789298770355604
384,swap,10939.0,419,15,20,1,35,0.35789298770355604
385,swap,10939.0,419,15,20,1,35,0.35789298770355604
386,swap,10939.0,419,15,20,1,35,0.35789298770355604
387,swap,10646.0,426,15,19,1,34,0.3627450980392157
388,swap,10646.0,426,15,19,1,34,0.3627450980392157
389,swap,10646.0,426,15,19,1,34,0.3627450980392157
390,swap,10646.0,426,15,19,1,34,0.3627450980392157
391,swap,10646.0,426,15,19,1,34,0.3627450980392157
392,swap,10646.0,426,15,19,1,34,0.3627450980392157
393,swap,10646.0,426,15,19,1,34,0.3627450980392157
394,swap,10646.0,426,15,19,1,34,0.3627450980392157
395,swap,10646.0,426,15,19,1,34,0.3627450980392157
396,swap,10646.0,426,15,19,1,34,0.3627450980392157
397,swap,10646.0,426,15,19,1,34,0.3627450980392157
398,swap,10646.0,426,15,19,1,34,0.3627450980392157
399,swap,10646.0,426,15,19,1,34,0.3627450980392157
400,swap,10646.0,426,15,19,1,34,0.3627450980392157
401,swap,10646.0,426,15,19,1,34,0.3627450980392157
402,swap,10646.0,426,15,19,1,34,0.3627450980392157
403,swap,10646.0,426,15,19,1,34,0.3627450980392157
404,swap,10646.0,426,15,19,1,34,0.3627450980392157
405,swap,10646.0,426,15,19,1,34,0.3627450980392157
406,swap,10644.0,424,15,19,1,34,0.3627450980392157
407,swap,10644.0,424,15,19,1,34,0.3627450980392157
408,swap,10644.0,424,15,19,1,34,0.3627450980392157
409,swap,10644.0,424,15,19,1,34,0.3627450980392157
410,swap,10644.0,424,15,19,1,34,0.3627450980392157
411,swap,10644.0,424,15,19,1,34,0.3627450980392157
412,swap,10644.0,424,15,19,1,34,0.3627450980392157
413,swap,10644.0,424,15,19,1,34,0.3627450980392157
414,swap,10644.0,424,15,19,1,34,0.3627450980392157
415,swap,10644.0,424,15,19,1,34,0.3627450980392157
416,swap,10644.0,424,15,19,1,34,0.3627450980392157
417,mut_micro,10644.0,424,15,19,1,34,0.3627450980392157
418,mut_micro,10644.0,424,15,19,1,34,0.3627450980392157
419,mut_micro,10644.0,424,15,19,1,34,0.3627450980392157
420,mut_micro,10644.0,424,15,19,1,34,0.3627450980392157
421,reassign,10644.0,424,15,19,1,34,0.3627450980392157
422,swap,10644.0,424,15,19,1,34,0.3627450980392157
423,swap,10644.0,424,15,19,1,34,0.3627450980392157
424,swap,10644.0,424,15,19,1,34,0.3627450980392157
425,swap,10644.0,424,15,19,1,34,0.3627450980392157
426,swap,10644.0,424,15,19,1,34,0.3627450980392157
427,swap,10644.0,424,15,19,1,34,0.3627450980392157
428,swap,10644.0,424,15,19,1,34,0.3627450980392157
429,swap,10644.0,424,15,19,1,34,0.3627450980392157
430,swap,10644.0,424,15,19,1,34,0.3627450980392157
431,swap,10644.0,424,15,19,1,34,0.3627450980392157
432,reassign,10644.0,424,15,19,1,34,0.3627450980392157
433,swap,10644.0,424,15,19,1,34,0.3627450980392157
434,swap,10644.0,424,15,19,1,34,0.3627450980392157
435,swap,10644.0,424,15,19,1,34,0.3627450980392157
436,swap,10644.0,424,15,19,1,34,0.3627450980392157
437,swap,10644.0,424,15,19,1,34,0.3627450980392157
438,swap,10644.0,424,15,19,1,34,0.3627450980392157
439,swap,10644.0,424,15,19,1,34,0.3627450980392157
440,swap,10644.0,424,15,19,1,34,0.3627450980392157
441,swap,10644.0,424,15,19,1,34,0.3627450980392157
442,swap,10644.0,424,15,19,1,34,0.3627450980392157
443,mut_micro,10644.0,424,15,19,1,34,0.3627450980392157
444,swap,10644.0,424,15,19,1,34,0.3627450980392157
445,swap,10644.0,424,15,19,1,34,0.3627450980392157
446,swap,10644.0,424,15,19,1,34,0.3627450980392157
447,swap,10644.0,424,15,19,1,34,0.3627450980392157
448,swap,10345.0,425,15,18,1,33,0.36457697265757527
449,swap,10345.0,425,15,18,1,33,0.36457697265757527
450,swap,10345.0,425,15,18,1,33,0.36457697265757527
451,swap,10345.0,425,15,18,1,33,0.36457697265757527
452,swap,10345.0,425,15,18,1,33,0.36457697265757527
453,swap,10345.0,425,15,18,1,33,0.36457697265757527
454,swap,10345.0,425,15,18,1,33,0.36457697265757527
455,swap,10345.0,425,15,18,1,33,0.36457697265757527
456,swap,10345.0,425,15,18,1,33,0.36457697265757527
457,swap,10345.0,425,15,18,1,33,0.36457697265757527
458,swap,10345.0,425,15,18,1,33,0.36457697265757527
459,swap,10345.0,425,15,18,1,33,0.36457697265757527
460,swap,10345.0,425,15,18,1,33,0.36457697265757527
461,mut_micro,10047.0,427,15,17,1,32,0.3661610985857758
462,swap,10047.0,427,15,17,1,32,0.3661610985857758
463,swap,10047.0,427,15,17,1,32,0.3661610985857758
464,swap,10047.0,427,15,17,1,32,0.3661610985857758
465,swap,10047.0,427,15,17,1,32,0.3661610985857758
466,swap,10047.0,427,15,17,1,32,0.3661610985857758
467,swap,10047.0,427,15,17,1,32,0.3661610985857758
468,swap,10047.0,427,15,17,1,32,0.3661610985857758
469,swap,10047.0,427,15,17,1,32,0.3661610985857758
470,mut_micro,10047.0,427,15,17,1,32,0.3661610985857758
471,swap,10047.0,427,15,17,1,32,0.3661610985857758
472,swap,10047.0,427,15,17,1,32,0.3661610985857758
473,mut_micro,10047.0,427,15,17,1,32,0.3661610985857758
474,reassign,10047.0,427,15,17,1,32,0.3661610985857758
475,swap,10047.0,427,15,17,1,32,0.3661610985857758
476,swap,10047.0,427,15,17,1,32,0.3661610985857758
477,swap,10047.0,427,15,17,1,32,0.3661610985857758
478,swap,10047.0,427,15,17,1,32,0.3661610985857758
479,swap,10047.0,427,15,17,1,32,0.3661610985857758
480,swap,10047.0,427,15,17,1,32,0.3661610985857758
481,swap,10047.0,427,15,17,1,32,0.3661610985857758
482,swap,10047.0,427,15,17,1,32,0.3661610985857758
483,swap,10047.0,427,15,17,1,32,0.3661610985857758
484,swap,10047.0,427,15,17,1,32,0.3661610985857758
485,swap,10047.0,427,15,17,1,32,0.3661610985857758
486,swap,10047.0,427,15,17,1,32,0.3661610985857758
487,swap,10047.0,427,15,17,1,32,0.3661610985857758
488,swap,10047.0,427,15,17,1,32,0.3661610985857758
489,swap,10047.0,427,15,17,1,32,0.3661610985857758
490,swap,10047.0,427,15,17,1,32,0.3661610985857758
491,reassign,10047.0,427,15,17,1,32,0.3661610985857758
492,mut_micro,10047.0,427,15,17,1,32,0.3661610985857758
493,reassign,10047.0,427,15,17,1,32,0.3661610985857758
494,swap,10047.0,427,15,17,1,32,0.3661610985857758
495,swap,10047.0,427,15,17,1,32,0.3661610985857758
496,swap,10047.0,427,15,17,1,32,0.3661610985857758
497,swap,10047.0,427,15,17,1,32,0.3661610985857758
498,swap,10047.0,427,15,17,1,32,0.3661610985857758
499,swap,10047.0,427,15,17,1,32,0.3661610985857758
500,swap,10047.0,427,15,17,1,32,0.3661610985857758
501,swap,10047.0,427,15,17,1,32,0.3661610985857758
502,swap,10047.0,427,15,17,1,32,0.3661610985857758
503,swap,10047.0,427,15,17,1,32,0.3661610985857758
504,swap,10045.0,425,15,17,1,32,0.3632200284958274
505,swap,10045.0,425,15,17,1,32,0.3632200284958274
506,swap,10045.0,425,15,17,1,32,0.3632200284958274
507,swap,10045.0,425,15,17,1,32,0.3632200284958274
508,swap,10045.0,425,15,17,1,32,0.3632200284958274
509,swap,10044.0,424,15,17,1,32,0.36450304259634886
510,swap,10044.0,424,15,17,1,32,0.36450304259634886
511,swap,10044.0,424,15,17,1,32,0.36450304259634886
512,swap,10044.0,424,15,17,1,32,0.36450304259634886
513,mut_micro,10044.0,424,15,17,1,32,0.36450304259634886
514,swap,10044.0,424,15,17,1,32,0.36450304259634886
515,swap,10044.0,424,15,17,1,32,0.36450304259634886
516,swap,10044.0,424,15,17,1,32,0.36450304259634886
517,swap,10044.0,424,15,17,1,32,0.36450304259634886
518,swap,10044.0,424,15,17,1,32,0.36450304259634886
519,swap,10044.0,424,15,17,1,32,0.36450304259634886
520,swap,10044.0,424,15,17,1,32,0.36450304259634886
521,swap,10044.0,424,15,17,1,32,0.36450304259634886
522,swap,10044.0,424,15,17,1,32,0.36450304259634886
523,swap,10044.0,424,15,17,1,32,0.36450304259634886
524,swap,10044.0,424,15,17,1,32,0.36450304259634886
525,swap,10044.0,424,15,17,1,32,0.36450304259634886
526,swap,10044.0,424,15,17,1,32,0.36450304259634886
527,swap,10044.0,424,15,17,1,32,0.36450304259634886
528,swap,10044.0,424,15,17,1,32,0.36450304259634886
529,swap,10044.0,424,15,17,1,32,0.36450304259634886
530,swap,10044.0,424,15,17,1,32,0.36450304259634886
531,swap,10044.0,424,15,17,1,32,0.36450304259634886
532,swap,10044.0,424,15,17,1,32,0.36450304259634886
533,swap,10044.0,424,15,17,1,32,0.36450304259634886
534,swap,10044.0,424,15,17,1,32,0.36450304259634886
535,swap,10044.0,424,15,17,1,32,0.36450304259634886
536,swap,10042.0,422,15,17,1,32,0.36146924523233953
537,swap,10042.0,422,15,17,1,32,0.36146924523233953
538,swap,10042.0,422,15,17,1,32,0.36146924523233953
539,swap,10042.0,422,15,17,1,32,0.36146924523233953
540,swap,10042.0,422,15,17,1,32,0.36146924523233953
541,swap,10042.0,422,15,17,1,32,0.36146924523233953
542,swap,10042.0,422,15,17,1,32,0.36146924523233953
543,swap,10042.0,422,15,17,1,32,0.36146924523233953
544,swap,10042.0,422,15,17,1,32,0.36146924523233953
545,swap,10042.0,422,15,17,1,32,0.36146924523233953
546,swap,10042.0,422,15,17,1,32,0.36146924523233953
547,swap,10042.0,422,15,17,1,32,0.36146924523233953
548,swap,10042.0,422,15,17,1,32,0.36146924523233953
549,swap,10042.0,422,15,17,1,32,0.36146924523233953
550,swap,10042.0,422,15,17,1,32,0.36146924523233953
551,swap,10042.0,422,15,17,1,32,0.36146924523233953
552,swap,10042.0,422,15,17,1,32,0.36146924523233953
553,reassign,10042.0,422,15,17,1,32,0.36146924523233953
554,swap,10042.0,422,15,17,1,32,0.36146924523233953
555,swap,10042.0,422,15,17,1,32,0.36146924523233953
556,swap,10042.0,422,15,17,1,32,0.36146924523233953
557,swap,10042.0,422,15,17,1,32,0.36146924523233953
558,reassign,10042.0,422,15,17,1,32,0.36146924523233953
559,swap,10042.0,422,15,17,1,32,0.36146924523233953
560,swap,10042.0,422,15,17,1,32,0.36146924523233953
561,swap,10042.0,422,15,17,1,32,0.36146924523233953
562,swap,10042.0,422,15,17,1,32,0.36146924523233953
563,swap,10042.0,422,15,17,1,32,0.36146924523233953
564,swap,10042.0,422,15,17,1,32,0.36146924523233953
565,swap,10042.0,422,15,17,1,32,0.36146924523233953
566,mut_micro,10042.0,422,15,17,1,32,0.36146924523233953
567,swap,10042.0,422,15,17,1,32,0.36146924523233953
568,swap,10042.0,422,15,17,1,32,0.36146924523233953
569,swap,10042.0,422,15,17,1,32,0.36146924523233953
570,swap,10042.0,422,15,17,1,32,0.36146924523233953
571,swap,10042.0,422,15,17,1,32,0.36146924523233953
572,swap,10042.0,422,15,17,1,32,0.36146924523233953
573,swap,10042.0,422,15,17,1,32,0.36146924523233953
574,swap,9750.0,430,15,16,1,31,0.3664733499033415
575,swap,9748.0,428,15,16,1,31,0.36822980940628
576,swap,9748.0,428,15,16,1,31,0.36822980940628
577,swap,9748.0,428,15,16,1,31,0.36822980940628
578,swap,9748.0,428,15,16,1,31,0.36822980940628
579,swap,9748.0,428,15,16,1,31,0.36822980940628
580,swap,9748.0,428,15,16,1,31,0.36822980940628
581,swap,9748.0,428,15,16,1,31,0.36822980940628
582,swap,9748.0,428,15,16,1,31,0.36822980940628
583,swap,9748.0,428,15,16,1,31,0.36822980940628
584,reassign,9748.0,428,15,16,1,31,0.36822980940628
585,swap,9748.0,428,15,16,1,31,0.36822980940628
586,swap,9748.0,428,15,16,1,31,0.36822980940628
587,swap,9748.0,428,15,16,1,31,0.36822980940628
588,swap,9748.0,428,15,16,1,31,0.36822980940628
589,swap,9748.0,428,15,16,1,31,0.36822980940628
590,swap,9748.0,428,15,16,1,31,0.36822980940628
591,swap,9748.0,428,15,16,1,31,0.36822980940628
592,swap,9748.0,428,15,16,1,31,0.36822980940628
593,swap,9748.0,428,15,16,1,31,0.36822980940628
594,swap,9748.0,428,15,16,1,31,0.36822980940628
595,mut_micro,9748.0,428,15,16,1,31,0.36822980940628
596,swap,9748.0,428,15,16,1,31,0.36822980940628
597,swap,9748.0,428,15,16,1,31,0.36822980940628
598,swap,9748.0,428,15,16,1,31,0.36822980940628
599,swap,9748.0,428,15,16,1,31,0.36822980940628
600,swap,9748.0,428,15,16,1,31,0.36822980940628
601,swap,9748.0,428,15,16,1,31,0.36822980940628
602,swap,9748.0,428,15,16,1,31,0.36822980940628
603,swap,9748.0,428,15,16,1,31,0.36822980940628
604,mut_micro,9748.0,428,15,16,1,31,0.36822980940628
605,swap,9748.0,428,15,16,1,31,0.36822980940628
606,swap,9748.0,428,15,16,1,31,0.36822980940628
607,swap,9748.0,428,15,16,1,31,0.36822980940628
608,swap,9748.0,428,15,16,1,31,0.36822980940628
609,swap,9748.0,428,15,16,1,31,0.36822980940628
610,reassign,9748.0,428,15,16,1,31,0.36822980940628
611,swap,9748.0,428,15,16,1,31,0.36822980940628
612,swap,9748.0,428,15,16,1,31,0.36822980940628
613,swap,9748.0,428,15,16,1,31,0.36822980940628
614,swap,9748.0,428,15,16,1,31,0.36822980940628
615,swap,9748.0,428,15,16,1,31,0.36822980940628
616,swap,9748.0,428,15,16,1,31,0.36822980940628
617,swap,9748.0,428,15,16,1,31,0.36822980940628
618,swap,9748.0,428,15,16,1,31,0.36822980940628
619,swap,9748.0,428,15,16,1,31,0.36822980940628
620,swap,9748.0,428,15,16,1,31,0.36822980940628
621,swap,9748.0,428,15,16,1,31,0.36822980940628
622,swap,9748.0,428,15,16,1,31,0.36822980940628
623,swap,9748.0,428,15,16,1,31,0.36822980940628
624,swap,9748.0,428,15,16,1,31,0.36822980940628
625,swap,9748.0,428,15,16,1,31,0.36822980940628
626,swap,9748.0,428,15,16,1,31,0.36822980940628
627,swap,9748.0,428,15,16,1,31,0.36822980940628
628,swap,9748.0,428,15,16,1,31,0.36822980940628
629,swap,9748.0,428,15,16,1,31,0.36822980940628
630,swap,9748.0,428,15,16,1,31,0.36822980940628
631,swap,9748.0,428,15,16,1,31,0.36822980940628
632,swap,9748.0,428,15,16,1,31,0.36822980940628
633,swap,9748.0,428,15,16,1,31,0.36822980940628
634,swap,9748.0,428,15,16,1,31,0.36822980940628
635,swap,9747.0,427,15,16,1,31,0.36636605861856947
636,swap,9747.0,427,15,16,1,31,0.36636605861856947
637,swap,9747.0,427,15,16,1,31,0.36636605861856947
638,swap,9747.0,427,15,16,1,31,0.36636605861856947
639,swap,9747.0,427,15,16,1,31,0.36636605861856947
640,swap,9747.0,427,15,16,1,31,0.36636605861856947
641,swap,9745.0,425,15,16,1,31,0.36335572291200213
642,swap,9745.0,425,15,16,1,31,0.36335572291200213
643,swap,9745.0,425,15,16,1,31,0.36335572291200213
644,swap,9745.0,425,15,16,1,31,0.36335572291200213
645,swap,9745.0,425,15,16,1,31,0.36335572291200213
646,swap,9745.0,425,15,16,1,31,0.36335572291200213
647,swap,9745.0,425,15,16,1,31,0.36335572291200213
648,swap,9745.0,425,15,16,1,31,0.36335572291200213
649,mut_micro,9420.0,420,14,16,0,30,0.361544617847139
650,swap,9420.0,420,14,16,0,30,0.361544617847139
651,swap,9420.0,420,14,16,0,30,0.361544617847139
652,swap,9420.0,420,14,16,0,30,0.361544617847139
653,swap,9420.0,420,14,16,0,30,0.361544617847139
654,swap,9420.0,420,14,16,0,30,0.361544617847139
655,swap,9420.0,420,14,16,0,30,0.361544617847139
656,swap,9420.0,420,14,16,0,30,0.361544617847139
657,swap,9420.0,420,14,16,0,30,0.361544617847139
658,swap,9420.0,420,14,16,0,30,0.361544617847139
659,swap,9420.0,420,14,16,0,30,0.361544617847139
660,swap,9420.0,420,14,16,0,30,0.361544617847139
661,swap,9420.0,420,14,16,0,30,0.361544617847139
662,swap,9420.0,420,14,16,0,30,0.361544617847139
663,swap,9420.0,420,14,16,0,30,0.361544617847139
664,swap,9420.0,420,14,16,0,30,0.361544617847139
665,swap,9420.0,420,14,16,0,30,0.361544617847139
666,reassign,9420.0,420,14,16,0,30,0.361544617847139
667,swap,9420.0,420,14,16,0,30,0.361544617847139
668,swap,9420.0,420,14,16,0,30,0.361544617847139
669,swap,9419.0,419,14,16,0,30,0.3611498836822864
670,swap,9419.0,419,14,16,0,30,0.3611498836822864
671,swap,9419.0,419,14,16,0,30,0.3611498836822864
672,swap,9419.0,419,14,16,0,30,0.3611498836822864
673,swap,9419.0,419,14,16,0,30,0.3611498836822864
674,swap,9419.0,419,14,16,0,30,0.3611498836822864
675,swap,9124.0,424,14,15,0,29,0.3630155510480055
676,swap,9124.0,424,14,15,0,29,0.3630155510480055
677,swap,9124.0,424,14,15,0,29,0.3630155510480055
678,swap,9124.0,424,14,15,0,29,0.3630155510480055
679,mut_micro,9124.0,424,14,15,0,29,0.3630155510480055
680,swap,9124.0,424,14,15,0,29,0.3630155510480055
681,swap,9124.0,424,14,15,0,29,0.3630155510480055
682,swap,9124.0,424,14,15,0,29,0.3630155510480055
683,swap,9124.0,424,14,15,0,29,0.3630155510480055
684,swap,9124.0,424,14,15,0,29,0.3630155510480055
685,swap,9124.0,424,14,15,0,29,0.3630155510480055
686,swap,9124.0,424,14,15,0,29,0.3630155510480055
687,swap,9124.0,424,14,15,0,29,0.3630155510480055
688,swap,9124.0,424,14,15,0,29,0.3630155510480055
689,swap,9124.0,424,14,15,0,29,0.3630155510480055
690,swap,9124.0,424,14,15,0,29,0.3630155510480055
691,swap,9124.0,424,14,15,0,29,0.3630155510480055
692,swap,9120.0,420,14,15,0,29,0.35994397759103647
693,swap,9120.0,420,14,15,0,29,0.35994397759103647
694,swap,8828.0,428,14,14,0,28,0.36507610037021804
695,swap,8828.0,428,14,14,0,28,0.36507610037021804
696,swap,8828.0,428,14,14,0,28,0.36507610037021804
697,swap,8828.0,428,14,14,0,28,0.36507610037021804
698,swap,8828.0,428,14,14,0,28,0.36507610037021804
699,swap,8828.0,428,14,14,0,28,0.36507610037021804
700,reassign,8827.0,427,14,14,0,28,0.36315501810480305
701,reassign,8827.0,427,14,14,0,28,0.36315501810480305
702,swap,8827.0,427,14,14,0,28,0.36315501810480305
703,swap,8827.0,427,14,14,0,28,0.36315501810480305
704,swap,8827.0,427,14,14,0,28,0.36315501810480305
705,swap,8825.0,425,14,14,0,28,0.3632200284958274
706,swap,8825.0,425,14,14,0,28,0.3632200284958274
707,swap,8825.0,425,14,14,0,28,0.3632200284958274
708,swap,8825.0,425,14,14,0,28,0.3632200284958274
709,swap,8825.0,425,14,14,0,28,0.3632200284958274
710,swap,8825.0,425,14,14,0,28,0.3632200284958274
711,swap,8825.0,425,14,14,0,28,0.3632200284958274
712,swap,8825.0,425,14,14,0,28,0.3632200284958274
713,swap,8825.0,425,14,14,0,28,0.3632200284958274
714,swap,8825.0,425,14,14,0,28,0.3632200284958274
715,swap,8825.0,425,14,14,0,28,0.3632200284958274
716,swap,8825.0,425,14,14,0,28,0.3632200284958274
717,swap,8825.0,425,14,14,0,28,0.3632200284958274
718,swap,8825.0,425,14,14,0,28,0.3632200284958274
719,mut_micro,8825.0,425,14,14,0,28,0.3632200284958274
720,swap,8825.0,425,14,14,0,28,0.3632200284958274
721,swap,8825.0,425,14,14,0,28,0.3632200284958274
722,swap,8825.0,425,14,14,0,28,0.3632200284958274
723,swap,8825.0,425,14,14,0,28,0.3632200284958274
724,swap,8825.0,425,14,14,0,28,0.3632200284958274
725,swap,8825.0,425,14,14,0,28,0.3632200284958274
726,swap,8825.0,425,14,14,0,28,0.3632200284958274
727,swap,8825.0,425,14,14,0,28,0.3632200284958274
728,swap,8825.0,425,14,14,0,28,0.3632200284958274
729,swap,8525.0,425,14,13,0,27,0.3632200284958274
730,swap,8525.0,425,14,13,0,27,0.3632200284958274
731,swap,8525.0,425,14,13,0,27,0.3632200284958274
732,swap,8525.0,425,14,13,0,27,0.3632200284958274
733,swap,8525.0,425,14,13,0,27,0.3632200284958274
734,swap,8525.0,425,14,13,0,27,0.3632200284958274
735,swap,8525.0,425,14,13,0,27,0.3632200284958274
736,swap,8525.0,425,14,13,0,27,0.3632200284958274
737,mut_micro,8525.0,425,14,13,0,27,0.3632200284958274
738,swap,8525.0,425,14,13,0,27,0.3632200284958274
739,swap,8525.0,425,14,13,0,27,0.3632200284958274
740,swap,8525.0,425,14,13,0,27,0.3632200284958274
741,swap,8525.0,425,14,13,0,27,0.3632200284958274
742,swap,8525.0,425,14,13,0,27,0.3632200284958274
743,swap,8525.0,425,14,13,0,27,0.3632200284958274
744,swap,8525.0,425,14,13,0,27,0.3632200284958274
745,swap,8525.0,425,14,13,0,27,0.3632200284958274
746,swap,8525.0,425,14,13,0,27,0.3632200284958274
747,swap,8525.0,425,14,13,0,27,0.3632200284958274
748,swap,8525.0,425,14,13,0,27,0.3632200284958274
749,swap,8525.0,425,14,13,0,27,0.3632200284958274
750,swap,8525.0,425,14,13,0,27,0.3632200284958274
751,swap,8525.0,425,14,13,0,27,0.3632200284958274
752,mut_micro,8521.0,421,13,14,0,27,0.3601351803520043
753,swap,8521.0,421,13,14,0,27,0.3601351803520043
754,swap,8521.0,421,13,14,0,27,0.3601351803520043
755,swap,8521.0,421,13,14,0,27,0.3601351803520043
756,swap,8521.0,421,13,14,0,27,0.3601351803520043
757,swap,8521.0,421,13,14,0,27,0.3601351803520043
758,swap,8221.0,421,13,13,0,26,0.3601351803520043
759,swap,8221.0,421,13,13,0,26,0.3601351803520043
760,swap,8221.0,421,13,13,0,26,0.3601351803520043
761,swap,8221.0,421,13,13,0,26,0.3601351803520043
762,swap,8221.0,421,13,13,0,26,0.3601351803520043
763,swap,8221.0,421,13,13,0,26,0.3601351803520043
764,swap,8221.0,421,13,13,0,26,0.3601351803520043
765,swap,8221.0,421,13,13,0,26,0.3601351803520043
766,swap,8221.0,421,13,13,0,26,0.3601351803520043
767,swap,8221.0,421,13,13,0,26,0.3601351803520043
768,swap,8221.0,421,13,13,0,26,0.3601351803520043
769,swap,8221.0,421,13,13,0,26,0.3601351803520043
770,swap,8221.0,421,13,13,0,26,0.3601351803520043
771,swap,8221.0,421,13,13,0,26,0.3601351803520043
772,swap,8221.0,421,13,13,0,26,0.3601351803520043
773,swap,8221.0,421,13,13,0,26,0.3601351803520043
774,swap,8221.0,421,13,13,0,26,0.3601351803520043
775,swap,8221.0,421,13,13,0,26,0.3601351803520043
776,swap,8221.0,421,13,13,0,26,0.3601351803520043
777,swap,8221.0,421,13,13,0,26,0.3601351803520043
778,swap,8221.0,421,13,13,0,26,0.3601351803520043
779,mut_micro,8221.0,421,13,13,0,26,0.3601351803520043
780,mut_micro,8221.0,421,13,13,0,26,0.3601351803520043
781,swap,8221.0,421,13,13,0,26,0.3601351803520043
782,swap,8221.0,421,13,13,0,26,0.3601351803520043
783,mut_micro,8221.0,421,13,13,0,26,0.3601351803520043
784,swap,8221.0,421,13,13,0,26,0.3601351803520043
785,swap,8221.0,421,13,13,0,26,0.3601351803520043
786,swap,8221.0,421,13,13,0,26,0.3601351803520043
787,swap,8221.0,421,13,13,0,26,0.3601351803520043
788,swap,8221.0,421,13,13,0,26,0.3601351803520043
789,swap,8221.0,421,13,13,0,26,0.3601351803520043
790,swap,8221.0,421,13,13,0,26,0.3601351803520043
791,swap,8221.0,421,13,13,0,26,0.3601351803520043
792,swap,8221.0,421,13,13,0,26,0.3601351803520043
793,swap,8221.0,421,13,13,0,26,0.3601351803520043
794,swap,8221.0,421,13,13,0,26,0.3601351803520043
795,swap,8221.0,421,13,13,0,26,0.3601351803520043
796,reassign,8221.0,421,13,13,0,26,0.3601351803520043
797,swap,8221.0,421,13,13,0,26,0.3601351803520043
798,swap,8221.0,421,13,13,0,26,0.3601351803520043
799,swap,8221.0,421,13,13,0,26,0.3601351803520043
800,swap,8221.0,421,13,13,0,26,0.3601351803520043
801,swap,8221.0,421,13,13,0,26,0.3601351803520043
802,swap,8221.0,421,13,13,0,26,0.3601351803520043
803,swap,8221.0,421,13,13,0,26,0.3601351803520043
804,swap,8221.0,421,13,13,0,26,0.3601351803520043
805,swap,8221.0,421,13,13,0,26,0.3601351803520043
806,swap,8221.0,421,13,13,0,26,0.3601351803520043
807,swap,8221.0,421,13,13,0,26,0.3601351803520043
808,swap,8221.0,421,13,13,0,26,0.3601351803520043
809,swap,8221.0,421,13,13,0,26,0.3601351803520043
810,swap,8221.0,421,13,13,0,26,0.3601351803520043
811,swap,8221.0,421,13,13,0,26,0.3601351803520043
812,reassign,7916.0,416,12,13,0,25,0.3581392288459007
813,swap,7916.0,416,12,13,0,25,0.3581392288459007
814,mut_micro,7916.0,416,12,13,0,25,0.3581392288459007
815,swap,7916.0,416,12,13,0,25,0.3581392288459007
816,swap,7916.0,416,12,13,0,25,0.3581392288459007
817,swap,7916.0,416,12,13,0,25,0.3581392288459007
818,swap,7916.0,416,12,13,0,25,0.3581392288459007
819,swap,7916.0,416,12,13,0,25,0.3581392288459007
820,swap,7916.0,416,12,13,0,25,0.3581392288459007
821,swap,7916.0,416,12,13,0,25,0.3581392288459007
822,swap,7916.0,416,12,13,0,25,0.3581392288459007
823,swap,7916.0,416,12,13,0,25,0.3581392288459007
824,swap,7916.0,416,12,13,0,25,0.3581392288459007
825,swap,7916.0,416,12,13,0,25,0.3581392288459007
826,swap,7916.0,416,12,13,0,25,0.3581392288459007
827,swap,7916.0,416,12,13,0,25,0.3581392288459007
828,swap,7916.0,416,12,13,0,25,0.3581392288459007
829,swap,7916.0,416,12,13,0,25,0.3581392288459007
830,swap,7916.0,416,12,13,0,25,0.3581392288459007
831,swap,7916.0,416,12,13,0,25,0.3581392288459007
832,swap,7916.0,416,12,13,0,25,0.3581392288459007
833,swap,7915.0,415,12,13,0,25,0.36149911469604573
834,swap,7915.0,415,12,13,0,25,0.36149911469604573
835,mut_micro,7318.0,418,11,12,0,23,0.360559088500265
836,swap,7318.0,418,11,12,0,23,0.360559088500265
837,swap,7318.0,418,11,12,0,23,0.360559088500265
838,swap,7318.0,418,11,12,0,23,0.360559088500265
839,swap,7318.0,418,11,12,0,23,0.360559088500265
840,swap,7318.0,418,11,12,0,23,0.360559088500265
841,swap,7318.0,418,11,12,0,23,0.360559088500265
842,swap,7318.0,418,11,12,0,23,0.360559088500265
843,swap,7318.0,418,11,12,0,23,0.360559088500265
844,swap,7318.0,418,11,12,0,23,0.360559088500265
845,swap,7318.0,418,11,12,0,23,0.360559088500265
846,swap,7318.0,418,11,12,0,23,0.360559088500265
847,swap,7318.0,418,11,12,0,23,0.360559088500265
848,swap,7318.0,418,11,12,0,23,0.360559088500265
849,swap,7318.0,418,11,12,0,23,0.360559088500265
850,swap,7318.0,418,11,12,0,23,0.360559088500265
851,swap,7318.0,418,11,12,0,23,0.360559088500265
852,swap,7318.0,418,11,12,0,23,0.360559088500265
853,swap,7318.0,418,11,12,0,23,0.360559088500265
854,swap,7318.0,418,11,12,0,23,0.360559088500265
855,swap,7318.0,418,11,12,0,23,0.360559088500265
856,swap,7318.0,418,11,12,0,23,0.360559088500265
857,reassign,7318.0,418,11,12,0,23,0.360559088500265
858,swap,7318.0,418,11,12,0,23,0.360559088500265
859,swap,7318.0,418,11,12,0,23,0.360559088500265
860,swap,7318.0,418,11,12,0,23,0.360559088500265
861,swap,7318.0,418,11,12,0,23,0.360559088500265
862,swap,7318.0,418,11,12,0,23,0.360559088500265
863,swap,7318.0,418,11,12,0,23,0.360559088500265
864,swap,7318.0,418,11,12,0,23,0.360559088500265
865,swap,7318.0,418,11,12,0,23,0.360559088500265
866,swap,7318.0,418,11,12,0,23,0.360559088500265
867,swap,7318.0,418,11,12,0,23,0.360559088500265
868,swap,7318.0,418,11,12,0,23,0.360559088500265
869,swap,7318.0,418,11,12,0,23,0.360559088500265
870,swap,7318.0,418,11,12,0,23,0.360559088500265
871,swap,7318.0,418,11,12,0,23,0.360559088500265
872,swap,7318.0,418,11,12,0,23,0.360559088500265
873,swap,7318.0,418,11,12,0,23,0.360559088500265
874,swap,7318.0,418,11,12,0,23,0.360559088500265
875,swap,7318.0,418,11,12,0,23,0.360559088500265
876,swap,7318.0,418,11,12,0,23,0.360559088500265
877,swap,7318.0,418,11,12,0,23,0.360559088500265
878,swap,7318.0,418,11,12,0,23,0.360559088500265
879,swap,7318.0,418,11,12,0,23,0.360559088500265
880,swap,7318.0,418,11,12,0,23,0.360559088500265
881,swap,7318.0,418,11,12,0,23,0.360559088500265
882,swap,7318.0,418,11,12,0,23,0.360559088500265
883,swap,7318.0,418,11,12,0,23,0.360559088500265
884,swap,7318.0,418,11,12,0,23,0.360559088500265
885,swap,7318.0,418,11,12,0,23,0.360559088500265
886,swap,7318.0,418,11,12,0,23,0.360559088500265
887,swap,7318.0,418,11,12,0,23,0.360559088500265
888,swap,7318.0,418,11,12,0,23,0.360559088500265
889,swap,7318.0,418,11,12,0,23,0.360559088500265
890,swap,7318.0,418,11,12,0,23,0.360559088500265
891,swap,7318.0,418,11,12,0,23,0.360559088500265
892,swap,7318.0,418,11,12,0,23,0.360559088500265
893,mut_micro,7318.0,418,11,12,0,23,0.360559088500265
894,swap,7318.0,418,11,12,0,23,0.360559088500265
895,swap,7318.0,418,11,12,0,23,0.360559088500265
896,swap,7318.0,418,11,12,0,23,0.360559088500265
897,swap,7318.0,418,11,12,0,23,0.360559088500265
898,swap,7318.0,418,11,12,0,23,0.360559088500265
899,swap,7318.0,418,11,12,0,23,0.360559088500265
900,swap,7318.0,418,11,12,0,23,0.360559088500265
901,swap,7318.0,418,11,12,0,23,0.360559088500265
902,mut_micro,7318.0,418,11,12,0,23,0.360559088500265
903,swap,7316.0,416,11,12,0,23,0.3581392288459007
904,swap,7316.0,416,11,12,0,23,0.3581392288459007
905,swap,7316.0,416,11,12,0,23,0.3581392288459007
906,swap,7316.0,416,11,12,0,23,0.3581392288459007
907,swap,7316.0,416,11,12,0,23,0.3581392288459007
908,swap,7316.0,416,11,12,0,23,0.3581392288459007
909,swap,7316.0,416,11,12,0,23,0.3581392288459007
910,swap,7313.0,413,11,12,0,23,0.35447202136668626
911,swap,7313.0,413,11,12,0,23,0.35447202136668626
912,swap,7313.0,413,11,12,0,23,0.35447202136668626
913,swap,7313.0,413,11,12,0,23,0.35447202136668626
914,swap,7313.0,413,11,12,0,23,0.35447202136668626
915,swap,7313.0,413,11,12,0,23,0.35447202136668626
916,mut_micro,7313.0,413,11,12,0,23,0.35447202136668626
917,swap,7313.0,413,11,12,0,23,0.35447202136668626
918,swap,7313.0,413,11,12,0,23,0.35447202136668626
919,swap,7313.0,413,11,12,0,23,0.35447202136668626
920,swap,7313.0,413,11,12,0,23,0.35447202136668626
921,swap,7313.0,413,11,12,0,23,0.35447202136668626
922,swap,7313.0,413,11,12,0,23,0.35447202136668626
923,swap,7313.0,413,11,12,0,23,0.35447202136668626
924,swap,7313.0,413,11,12,0,23,0.35447202136668626
925,swap,7313.0,413,11,12,0,23,0.35447202136668626
926,mut_micro,7313.0,413,11,12,0,23,0.35447202136668626
927,swap,7313.0,413,11,12,0,23,0.35447202136668626
928,swap,7313.0,413,11,12,0,23,0.35447202136668626
929,swap,7313.0,413,11,12,0,23,0.35447202136668626
930,swap,7313.0,413,11,12,0,23,0.35447202136668626
931,swap,7313.0,413,11,12,0,23,0.35447202136668626
932,swap,7313.0,413,11,12,0,23,0.35447202136668626
933,swap,7313.0,413,11,12,0,23,0.35447202136668626
934,swap,7313.0,413,11,12,0,23,0.35447202136668626
935,swap,7313.0,413,11,12,0,23,0.35447202136668626
936,swap,7313.0,413,11,12,0,23,0.35447202136668626
937,swap,7313.0,413,11,12,0,23,0.35447202136668626
938,swap,7313.0,413,11,12,0,23,0.35447202136668626
939,swap,7313.0,413,11,12,0,23,0.35447202136668626
940,reassign,7313.0,413,11,12,0,23,0.35447202136668626
941,swap,7310.0,410,11,12,0,23,0.35532765737874095
942,swap,7310.0,410,11,12,0,23,0.35532765737874095
943,swap,7310.0,410,11,12,0,23,0.35532765737874095
944,swap,7310.0,410,11,12,0,23,0.35532765737874095
945,swap,7305.0,405,11,12,0,23,0.35278253696300527
946,swap,7300.0,400,11,12,0,23,0.34769576620457093
947,swap,7300.0,400,11,12,0,23,0.34769576620457093
948,swap,7300.0,400,11,12,0,23,0.34769576620457093
949,swap,7300.0,400,11,12,0,23,0.34769576620457093
950,swap,7300.0,400,11,12,0,23,0.34769576620457093
951,swap,7300.0,400,11,12,0,23,0.34769576620457093
952,swap,7300.0,400,11,12,0,23,0.34769576620457093
953,swap,7300.0,400,11,12,0,23,0.34769576620457093
954,swap,7300.0,400,11,12,0,23,0.34769576620457093
955,swap,7300.0,400,11,12,0,23,0.34769576620457093
956,swap,7300.0,400,11,12,0,23,0.34769576620457093
957,swap,7300.0,400,11,12,0,23,0.34769576620457093
958,swap,7300.0,400,11,12,0,23,0.34769576620457093
959,swap,7300.0,400,11,12,0,23,0.34769576620457093
960,swap,7300.0,400,11,12,0,23,0.34769576620457093
961,swap,7300.0,400,11,12,0,23,0.34769576620457093
962,swap,7300.0,400,11,12,0,23,0.34769576620457093
963,swap,7300.0,400,11,12,0,23,0.34769576620457093
964,swap,7300.0,400,11,12,0,23,0.34769576620457093
965,swap,7300.0,400,11,12,0,23,0.34769576620457093
966,swap,7300.0,400,11,12,0,23,0.34769576620457093
967,swap,7300.0,400,11,12,0,23,0.34769576620457093
968,swap,7300.0,400,11,12,0,23,0.34769576620457093
969,swap,7300.0,400,11,12,0,23,0.34769576620457093
970,swap,7300.0,400,11,12,0,23,0.34769576620457093
971,swap,7300.0,400,11,12,0,23,0.34769576620457093
972,swap,7300.0,400,11,12,0,23,0.34769576620457093
973,swap,7300.0,400,11,12,0,23,0.34769576620457093
974,swap,7300.0,400,11,12,0,23,0.34769576620457093
975,swap,7300.0,400,11,12,0,23,0.34769576620457093
976,swap,7300.0,400,11,12,0,23,0.34769576620457093
977,swap,7300.0,400,11,12,0,23,0.34769576620457093
978,swap,7300.0,400,11,12,0,23,0.34769576620457093
979,mut_micro,7300.0,400,11,12,0,23,0.34769576620457093
980,swap,7300.0,400,11,12,0,23,0.34769576620457093
981,swap,7300.0,400,11,12,0,23,0.34769576620457093
982,swap,7300.0,400,11,12,0,23,0.34769576620457093
983,swap,7300.0,400,11,12,0,23,0.34769576620457093
984,swap,7300.0,400,11,12,0,23,0.34769576620457093
985,swap,7300.0,400,11,12,0,23,0.34769576620457093
986,swap,7300.0,400,11,12,0,23,0.34769576620457093
987,swap,7300.0,400,11,12,0,23,0.34769576620457093
988,swap,7300.0,400,11,12,0,23,0.34769576620457093
989,swap,7300.0,400,11,12,0,23,0.34769576620457093
990,swap,7300.0,400,11,12,0,23,0.34769576620457093
991,swap,7300.0,400,11,12,0,23,0.34769576620457093
992,mut_micro,7300.0,400,11,12,0,23,0.34769576620457093
993,swap,7300.0,400,11,12,0,23,0.34769576620457093
994,swap,7300.0,400,11,12,0,23,0.34769576620457093
995,mut_micro,7300.0,400,11,12,0,23,0.34769576620457093
996,swap,7300.0,400,11,12,0,23,0.34769576620457093
997,swap,7300.0,400,11,12,0,23,0.34769576620457093
998,swap,7300.0,400,11,12,0,23,0.34769576620457093
999,swap,7300.0,400,11,12,0,23,0.34769576620457093
1000,swap,7300.0,400,11,12,0,23,0.34769576620457093
