iter,op,fitness_score,pref_penalty,capacity_viol,elig_viol,under_cap,total_violations,gini
1,swap,31503.0,383,43,60,11,103,0.30007108583614706
2,reassign,31503.0,383,43,60,11,103,0.30007108583614706
3,mut_micro,31202.0,382,42,60,11,102,0.29736593432553754
4,mut_micro,31202.0,382,42,60,11,102,0.29736593432553754
5,swap,31202.0,382,42,60,11,102,0.29736593432553754
6,mut_micro,30901.0,381,41,60,11,101,0.29585467820761946
7,mut_micro,30302.0,382,39,60,11,99,0.2962437987243091
8,mut_micro,30302.0,382,39,60,11,99,0.2962437987243091
9,mut_micro,29704.0,384,37,60,11,97,0.2961972667855021
10,mut_micro,29704.0,384,37,60,11,97,0.2961972667855021
11,mut_micro,29685.0,385,37,60,10,97,0.29772334465701183
12,mut_micro,29685.0,385,37,60,10,97,0.29772334465701183
13,mut_micro,29685.0,385,37,60,10,97,0.29772334465701183
14,mut_micro,29386.0,386,37,59,10,96,0.2972859875657581
15,mut_micro,29385.0,385,36,60,10,96,0.29450503605697603
16,mut_micro,29385.0,385,36,60,10,96,0.29450503605697603
17,mut_micro,29350.0,390,35,61,8,96,0.29720406681191003
18,mut_micro,29350.0,390,35,61,8,96,0.29720406681191003
19,mut_micro,29350.0,390,35,61,8,96,0.29720406681191003
20,mut_micro,29350.0,390,35,61,8,96,0.29720406681191003
21,mut_micro,29047.0,387,34,61,8,95,0.2926485578941057
22,mut_micro,29044.0,384,34,61,8,95,0.2941770647653
23,mut_micro,29044.0,384,34,61,8,95,0.2941770647653
24,swap,29044.0,384,34,61,8,95,0.2941770647653
25,mut_micro,29044.0,384,34,61,8,95,0.2941770647653
26,mut_micro,28705.0,385,32,62,6,94,0.29694856666070685
27,mut_micro,28404.0,384,33,60,6,93,0.29821746880570416
28,mut_micro,28404.0,384,33,60,6,93,0.29821746880570416
29,mut_micro,28065.0,385,32,60,4,92,0.3009416532570475
30,swap,28064.0,384,32,60,4,92,0.3036244800950683
31,mut_micro,27762.0,382,33,58,4,91,0.30161823765650847
32,mut_micro,27501.0,381,34,56,6,90,0.3019784490372727
33,mut_micro,27499.0,379,34,56,6,90,0.3017559262510976
34,mut_micro,27499.0,379,34,56,6,90,0.3017559262510976
35,mut_micro,27497.0,377,34,56,6,90,0.29757956595100954
36,mut_micro,27497.0,377,34,56,6,90,0.29757956595100954
37,mut_micro,26598.0,378,32,55,6,87,0.2972689075630253
38,mut_micro,25694.0,374,30,54,6,84,0.29659746251441765
39,mut_micro,25395.0,375,28,55,6,83,0.29819538434842957
40,mut_micro,25395.0,375,28,55,6,83,0.29819538434842957
41,reassign,24797.0,377,27,54,6,81,0.2984523186129052
42,mut_micro,24796.0,376,27,54,6,81,0.2968441814595662
43,mut_micro,24796.0,376,27,54,6,81,0.2968441814595662
44,mut_micro,24796.0,376,27,54,6,81,0.2968441814595662
45,mut_micro,24500.0,380,26,54,6,80,0.30122108723729024
46,mut_micro,24199.0,379,25,54,6,79,0.299590283874744
47,mut_micro,24197.0,377,25,54,6,79,0.30107057659859204
48,mut_micro,24197.0,377,25,54,6,79,0.30107057659859204
49,mut_micro,24197.0,377,25,54,6,79,0.30107057659859204
50,mut_micro,24197.0,377,25,54,6,79,0.30107057659859204
51,mut_micro,23896.0,376,24,54,6,78,0.29846849982596596
52,swap,23603.0,383,24,53,6,77,0.3058764291214976
53,mut_micro,23603.0,383,24,53,6,77,0.3058764291214976
54,mut_micro,23603.0,383,24,53,6,77,0.3058764291214976
55,mut_micro,23282.0,382,23,53,5,76,0.30327191117410834
56,mut_micro,22678.0,378,21,53,5,74,0.3026960784313727
57,mut_micro,22678.0,378,21,53,5,74,0.3026960784313727
58,mut_micro,22678.0,378,21,53,5,74,0.3026960784313727
59,mut_micro,22675.0,375,22,52,5,74,0.30085603562959096
60,mut_micro,22672.0,372,21,53,5,74,0.296066964797615
61,mut_micro,22672.0,372,21,53,5,74,0.296066964797615
62,mut_micro,22672.0,372,21,53,5,74,0.296066964797615
63,mut_micro,22672.0,372,21,53,5,74,0.296066964797615
64,mut_micro,22672.0,372,21,53,5,74,0.296066964797615
65,mut_micro,22672.0,372,21,53,5,74,0.296066964797615
66,mut_micro,22331.0,371,20,53,3,73,0.29711884753901563
67,mut_micro,22034.0,374,20,52,3,72,0.2963091118800462
68,mut_micro,21416.0,376,19,51,2,70,0.2964381018679662
69,mut_micro,21114.0,374,19,50,2,69,0.29423298731257225
70,mut_micro,20812.0,372,18,50,2,68,0.28987501433321883
71,mut_micro,20812.0,372,18,50,2,68,0.28987501433321883
72,mut_micro,20812.0,372,18,50,2,68,0.28987501433321883
73,mut_micro,20810.0,370,17,51,2,68,0.29132466940264484
74,reassign,20810.0,370,17,51,2,68,0.29132466940264484
75,mut_micro,20809.0,369,17,51,2,68,0.2907928388746802
76,mut_micro,20510.0,370,16,51,2,67,0.2897286821705428
77,reassign,20510.0,370,16,51,2,67,0.2897286821705428
78,mut_micro,20510.0,370,16,51,2,67,0.2897286821705428
79,mut_micro,20510.0,370,16,51,2,67,0.2897286821705428
80,mut_micro,20510.0,370,16,51,2,67,0.2897286821705428
81,mut_micro,20510.0,370,16,51,2,67,0.2897286821705428
82,mut_micro,20510.0,370,16,51,2,67,0.2897286821705428
83,mut_micro,20510.0,370,16,51,2,67,0.2897286821705428
84,mut_micro,20207.0,367,15,51,2,66,0.2847657795106515
85,mut_micro,19905.0,365,15,50,2,65,0.28032473734479463
86,mut_micro,19905.0,365,15,50,2,65,0.28032473734479463
87,mut_micro,19905.0,365,15,50,2,65,0.28032473734479463
88,mut_micro,19905.0,365,15,50,2,65,0.28032473734479463
89,swap,19905.0,365,15,50,2,65,0.28032473734479463
90,mut_micro,19604.0,364,14,50,2,64,0.27764705882352964
91,mut_micro,19604.0,364,14,50,2,64,0.27764705882352964
92,mut_micro,19604.0,364,14,50,2,64,0.27764705882352964
93,mut_micro,19604.0,364,14,50,2,64,0.27764705882352964
94,swap,19604.0,364,14,50,2,64,0.27764705882352964
95,swap,19604.0,364,14,50,2,64,0.27764705882352964
96,mut_micro,19306.0,366,14,49,2,63,0.2821162947937795
97,swap,19306.0,366,14,49,2,63,0.2821162947937795
98,swap,19306.0,366,14,49,2,63,0.2821162947937795
99,swap,19306.0,366,14,49,2,63,0.2821162947937795
100,swap,19306.0,366,14,49,2,63,0.2821162947937795
101,swap,19306.0,366,14,49,2,63,0.2821162947937795
102,mut_micro,19303.0,363,14,49,2,63,0.2770515613652869
103,mut_micro,19303.0,363,14,49,2,63,0.2770515613652869
104,mut_micro,19303.0,363,14,49,2,63,0.2770515613652869
105,mut_micro,19303.0,363,14,49,2,63,0.2770515613652869
106,mut_micro,19303.0,363,14,49,2,63,0.2770515613652869
107,reassign,19301.0,361,14,49,2,63,0.27675942898405836
108,mut_micro,19301.0,361,14,49,2,63,0.27675942898405836
109,mut_micro,19301.0,361,14,49,2,63,0.27675942898405836
110,swap,19301.0,361,14,49,2,63,0.27675942898405836
111,reassign,19297.0,357,14,49,2,63,0.271900917229637
112,swap,19297.0,357,14,49,2,63,0.271900917229637
113,swap,19297.0,357,14,49,2,63,0.271900917229637
114,swap,19297.0,357,14,49,2,63,0.271900917229637
115,mut_micro,19297.0,357,14,49,2,63,0.271900917229637
116,swap,19297.0,357,14,49,2,63,0.271900917229637
117,swap,19297.0,357,14,49,2,63,0.271900917229637
118,swap,18704.0,364,14,47,2,61,0.28184873949579853
119,swap,18704.0,364,14,47,2,61,0.28184873949579853
120,swap,18704.0,364,14,47,2,61,0.28184873949579853
121,swap,18704.0,364,14,47,2,61,0.28184873949579853
122,reassign,18403.0,363,13,47,2,60,0.2821350762527234
123,swap,18403.0,363,13,47,2,60,0.2821350762527234
124,swap,18403.0,363,13,47,2,60,0.2821350762527234
125,swap,18403.0,363,13,47,2,60,0.2821350762527234
126,reassign,18403.0,363,13,47,2,60,0.2821350762527234
127,swap,18403.0,363,13,47,2,60,0.2821350762527234
128,swap,18403.0,363,13,47,2,60,0.2821350762527234
129,swap,18403.0,363,13,47,2,60,0.2821350762527234
130,swap,18403.0,363,13,47,2,60,0.2821350762527234
131,swap,18111.0,371,13,46,2,59,0.29065912079117356
132,swap,18111.0,371,13,46,2,59,0.29065912079117356
133,swap,18111.0,371,13,46,2,59,0.29065912079117356
134,swap,17819.0,379,13,45,2,58,0.2987708516242319
135,swap,17819.0,379,13,45,2,58,0.2987708516242319
136,swap,17819.0,379,13,45,2,58,0.2987708516242319
137,swap,17819.0,379,13,45,2,58,0.2987708516242319
138,swap,17819.0,379,13,45,2,58,0.2987708516242319
139,swap,17819.0,379,13,45,2,58,0.2987708516242319
140,swap,17819.0,379,13,45,2,58,0.2987708516242319
141,swap,17819.0,379,13,45,2,58,0.2987708516242319
142,swap,17819.0,379,13,45,2,58,0.2987708516242319
143,swap,17819.0,379,13,45,2,58,0.2987708516242319
144,swap,17819.0,379,13,45,2,58,0.2987708516242319
145,swap,17819.0,379,13,45,2,58,0.2987708516242319
146,swap,17819.0,379,13,45,2,58,0.2987708516242319
147,swap,17819.0,379,13,45,2,58,0.2987708516242319
148,reassign,17523.0,383,13,44,2,57,0.2992417510810971
149,reassign,17523.0,383,13,44,2,57,0.2992417510810971
150,swap,17523.0,383,13,44,2,57,0.2992417510810971
151,reassign,17523.0,383,13,44,2,57,0.2992417510810971
152,swap,17228.0,388,13,43,2,56,0.30500421027306635
153,swap,17228.0,388,13,43,2,56,0.30500421027306635
154,swap,17228.0,388,13,43,2,56,0.30500421027306635
155,swap,17228.0,388,13,43,2,56,0.30500421027306635
156,swap,16930.0,390,13,42,2,55,0.3091261195836359
157,swap,16930.0,390,13,42,2,55,0.3091261195836359
158,reassign,16930.0,390,13,42,2,55,0.3091261195836359
159,swap,16930.0,390,13,42,2,55,0.3091261195836359
160,swap,16930.0,390,13,42,2,55,0.3091261195836359
161,swap,16930.0,390,13,42,2,55,0.3091261195836359
162,swap,16930.0,390,13,42,2,55,0.3091261195836359
163,swap,16930.0,390,13,42,2,55,0.3091261195836359
164,swap,16930.0,390,13,42,2,55,0.3091261195836359
165,swap,16930.0,390,13,42,2,55,0.3091261195836359
166,swap,16930.0,390,13,42,2,55,0.3091261195836359
167,swap,16930.0,390,13,42,2,55,0.3091261195836359
168,swap,16930.0,390,13,42,2,55,0.3091261195836359
169,reassign,16930.0,390,13,42,2,55,0.3091261195836359
170,swap,16930.0,390,13,42,2,55,0.3091261195836359
171,swap,16930.0,390,13,42,2,55,0.3091261195836359
172,swap,16930.0,390,13,42,2,55,0.3091261195836359
173,swap,16634.0,394,13,41,2,54,0.3161151960784313
174,swap,16634.0,394,13,41,2,54,0.3161151960784313
175,swap,16634.0,394,13,41,2,54,0.3161151960784313
176,swap,16634.0,394,13,41,2,54,0.3161151960784313
177,swap,16634.0,394,13,41,2,54,0.3161151960784313
178,swap,16634.0,394,13,41,2,54,0.3161151960784313
179,mut_micro,16634.0,394,13,41,2,54,0.3161151960784313
180,swap,16634.0,394,13,41,2,54,0.3161151960784313
181,swap,16634.0,394,13,41,2,54,0.3161151960784313
182,swap,16634.0,394,13,41,2,54,0.3161151960784313
183,swap,16634.0,394,13,41,2,54,0.3161151960784313
184,swap,16634.0,394,13,41,2,54,0.3161151960784313
185,swap,16634.0,394,13,41,2,54,0.3161151960784313
186,swap,16634.0,394,13,41,2,54,0.3161151960784313
187,swap,16634.0,394,13,41,2,54,0.3161151960784313
188,swap,16634.0,394,13,41,2,54,0.3161151960784313
189,mut_micro,16634.0,394,13,41,2,54,0.3161151960784313
190,swap,16634.0,394,13,41,2,54,0.3161151960784313
191,swap,16634.0,394,13,41,2,54,0.3161151960784313
192,swap,16634.0,394,13,41,2,54,0.3161151960784313
193,swap,16634.0,394,13,41,2,54,0.3161151960784313
194,swap,16634.0,394,13,41,2,54,0.3161151960784313
195,swap,16340.0,400,13,40,2,53,0.3211564880729361
196,swap,16340.0,400,13,40,2,53,0.3211564880729361
197,swap,16340.0,400,13,40,2,53,0.3211564880729361
198,swap,16340.0,400,13,40,2,53,0.3211564880729361
199,swap,16340.0,400,13,40,2,53,0.3211564880729361
200,swap,16340.0,400,13,40,2,53,0.3211564880729361
201,swap,16340.0,400,13,40,2,53,0.3211564880729361
202,swap,16340.0,400,13,40,2,53,0.3211564880729361
203,swap,16340.0,400,13,40,2,53,0.3211564880729361
204,reassign,16340.0,400,13,40,2,53,0.3211564880729361
205,swap,16340.0,400,13,40,2,53,0.3211564880729361
206,swap,16339.0,399,13,40,2,53,0.3236539060068472
207,reassign,16339.0,399,13,40,2,53,0.3236539060068472
208,swap,16339.0,399,13,40,2,53,0.3236539060068472
209,swap,16339.0,399,13,40,2,53,0.3236539060068472
210,swap,16041.0,401,13,39,2,52,0.3274760383386581
211,mut_micro,16041.0,401,13,39,2,52,0.3274760383386581
212,swap,16041.0,401,13,39,2,52,0.3274760383386581
213,swap,16041.0,401,13,39,2,52,0.3274760383386581
214,swap,16041.0,401,13,39,2,52,0.3274760383386581
215,swap,16041.0,401,13,39,2,52,0.3274760383386581
216,swap,16041.0,401,13,39,2,52,0.3274760383386581
217,swap,16041.0,401,13,39,2,52,0.3274760383386581
218,swap,16041.0,401,13,39,2,52,0.3274760383386581
219,swap,16041.0,401,13,39,2,52,0.3274760383386581
220,swap,16041.0,401,13,39,2,52,0.3274760383386581
221,swap,16041.0,401,13,39,2,52,0.3274760383386581
222,swap,16041.0,401,13,39,2,52,0.3274760383386581
223,swap,15743.0,403,13,38,2,51,0.33210390265430934
224,swap,15743.0,403,13,38,2,51,0.33210390265430934
225,swap,15743.0,403,13,38,2,51,0.33210390265430934
226,swap,15444.0,404,13,37,2,50,0.33434535104364316
227,swap,15444.0,404,13,37,2,50,0.33434535104364316
228,swap,15444.0,404,13,37,2,50,0.33434535104364316
229,swap,15444.0,404,13,37,2,50,0.33434535104364316
230,swap,15444.0,404,13,37,2,50,0.33434535104364316
231,swap,15444.0,404,13,37,2,50,0.33434535104364316
232,swap,15444.0,404,13,37,2,50,0.33434535104364316
233,swap,15147.0,407,13,36,2,49,0.3384109344063358
234,swap,15147.0,407,13,36,2,49,0.3384109344063358
235,swap,15147.0,407,13,36,2,49,0.3384109344063358
236,swap,15147.0,407,13,36,2,49,0.3384109344063358
237,swap,15147.0,407,13,36,2,49,0.3384109344063358
238,swap,15147.0,407,13,36,2,49,0.3384109344063358
239,swap,15147.0,407,13,36,2,49,0.3384109344063358
240,swap,15147.0,407,13,36,2,49,0.3384109344063358
241,swap,15147.0,407,13,36,2,49,0.3384109344063358
242,swap,14854.0,414,13,35,2,48,0.3458169934640522
243,swap,14854.0,414,13,35,2,48,0.3458169934640522
244,mut_micro,14854.0,414,13,35,2,48,0.3458169934640522
245,swap,14556.0,416,13,34,2,47,0.3492564811159363
246,swap,14556.0,416,13,34,2,47,0.3492564811159363
247,swap,14556.0,416,13,34,2,47,0.3492564811159363
248,swap,14556.0,416,13,34,2,47,0.3492564811159363
249,swap,14552.0,412,13,34,2,47,0.3458641734839632
250,swap,14552.0,412,13,34,2,47,0.3458641734839632
251,swap,14552.0,412,13,34,2,47,0.3458641734839632
252,swap,14552.0,412,13,34,2,47,0.3458641734839632
253,swap,14552.0,412,13,34,2,47,0.3458641734839632
254,swap,14552.0,412,13,34,2,47,0.3458641734839632
255,swap,14552.0,412,13,34,2,47,0.3458641734839632
256,swap,14552.0,412,13,34,2,47,0.3458641734839632
257,swap,14552.0,412,13,34,2,47,0.3458641734839632
258,swap,14552.0,412,13,34,2,47,0.3458641734839632
259,swap,14552.0,412,13,34,2,47,0.3458641734839632
260,swap,14552.0,412,13,34,2,47,0.3458641734839632
261,swap,14552.0,412,13,34,2,47,0.3458641734839632
262,swap,14552.0,412,13,34,2,47,0.3458641734839632
263,swap,14256.0,416,13,33,2,46,0.3492564811159363
264,swap,14256.0,416,13,33,2,46,0.3492564811159363
265,swap,14256.0,416,13,33,2,46,0.3492564811159363
266,reassign,14251.0,411,13,33,2,46,0.34714942082443545
267,swap,14251.0,411,13,33,2,46,0.34714942082443545
268,swap,14251.0,411,13,33,2,46,0.34714942082443545
269,swap,14246.0,406,13,33,2,46,0.345492742551566
270,swap,14246.0,406,13,33,2,46,0.345492742551566
271,swap,14246.0,406,13,33,2,46,0.345492742551566
272,mut_micro,14246.0,406,13,33,2,46,0.345492742551566
273,swap,14246.0,406,13,33,2,46,0.345492742551566
274,swap,14246.0,406,13,33,2,46,0.345492742551566
275,swap,13944.0,404,13,32,2,45,0.3452877925363694
276,swap,13944.0,404,13,32,2,45,0.3452877925363694
277,swap,13944.0,404,13,32,2,45,0.3452877925363694
278,swap,13944.0,404,13,32,2,45,0.3452877925363694
279,swap,13651.0,411,13,31,2,44,0.35277939558661753
280,swap,13651.0,411,13,31,2,44,0.35277939558661753
281,swap,13651.0,411,13,31,2,44,0.35277939558661753
282,swap,13646.0,406,13,31,2,44,0.3503310415075121
283,swap,13646.0,406,13,31,2,44,0.3503310415075121
284,swap,13646.0,406,13,31,2,44,0.3503310415075121
285,swap,13646.0,406,13,31,2,44,0.3503310415075121
286,swap,13346.0,406,13,30,2,43,0.3503310415075121
287,swap,13346.0,406,13,30,2,43,0.3503310415075121
288,reassign,13346.0,406,13,30,2,43,0.3503310415075121
289,swap,13346.0,406,13,30,2,43,0.3503310415075121
290,swap,13346.0,406,13,30,2,43,0.3503310415075121
291,swap,13346.0,406,13,30,2,43,0.3503310415075121
292,swap,13346.0,406,13,30,2,43,0.3503310415075121
293,swap,13346.0,406,13,30,2,43,0.3503310415075121
294,swap,13346.0,406,13,30,2,43,0.3503310415075121
295,swap,13346.0,406,13,30,2,43,0.3503310415075121
296,swap,13346.0,406,13,30,2,43,0.3503310415075121
297,swap,13344.0,404,13,30,2,43,0.3500316255534472
298,swap,13344.0,404,13,30,2,43,0.3500316255534472
299,reassign,13049.0,409,12,30,2,42,0.3525875924140147
300,swap,13049.0,409,12,30,2,42,0.3525875924140147
301,swap,13049.0,409,12,30,2,42,0.3525875924140147
302,swap,13049.0,409,12,30,2,42,0.3525875924140147
303,swap,13049.0,409,12,30,2,42,0.3525875924140147
304,swap,13049.0,409,12,30,2,42,0.3525875924140147
305,swap,13049.0,409,12,30,2,42,0.3525875924140147
306,swap,13049.0,409,12,30,2,42,0.3525875924140147
307,swap,13049.0,409,12,30,2,42,0.3525875924140147
308,reassign,13049.0,409,12,30,2,42,0.3525875924140147
309,swap,13049.0,409,12,30,2,42,0.3525875924140147
310,swap,13049.0,409,12,30,2,42,0.3525875924140147
311,swap,13049.0,409,12,30,2,42,0.3525875924140147
312,swap,13049.0,409,12,30,2,42,0.3525875924140147
313,reassign,12772.0,412,12,29,3,41,0.3541098558628749
314,swap,12772.0,412,12,29,3,41,0.3541098558628749
315,swap,12772.0,412,12,29,3,41,0.3541098558628749
316,swap,12772.0,412,12,29,3,41,0.3541098558628749
317,swap,12772.0,412,12,29,3,41,0.3541098558628749
318,swap,12772.0,412,12,29,3,41,0.3541098558628749
319,swap,12772.0,412,12,29,3,41,0.3541098558628749
320,reassign,12772.0,412,12,29,3,41,0.3541098558628749
321,swap,12772.0,412,12,29,3,41,0.3541098558628749
322,swap,12477.0,417,12,28,3,40,0.35627517000066017
323,swap,12477.0,417,12,28,3,40,0.35627517000066017
324,swap,12477.0,417,12,28,3,40,0.35627517000066017
325,swap,12477.0,417,12,28,3,40,0.35627517000066017
326,swap,12477.0,417,12,28,3,40,0.35627517000066017
327,swap,12477.0,417,12,28,3,40,0.35627517000066017
328,swap,12477.0,417,12,28,3,40,0.35627517000066017
329,swap,12477.0,417,12,28,3,40,0.35627517000066017
330,reassign,12477.0,417,12,28,3,40,0.35627517000066017
331,swap,12477.0,417,12,28,3,40,0.35627517000066017
332,swap,12477.0,417,12,28,3,40,0.35627517000066017
333,swap,12477.0,417,12,28,3,40,0.35627517000066017
334,swap,12477.0,417,12,28,3,40,0.35627517000066017
335,swap,12475.0,415,12,28,3,40,0.35618729096989965
336,swap,12475.0,415,12,28,3,40,0.35618729096989965
337,swap,12475.0,415,12,28,3,40,0.35618729096989965
338,swap,12475.0,415,12,28,3,40,0.35618729096989965
339,swap,12183.0,423,12,27,3,39,0.356815578465063
340,swap,12183.0,423,12,27,3,39,0.356815578465063
341,swap,11885.0,425,12,26,3,38,0.35996336250763283
342,mut_micro,11885.0,425,12,26,3,38,0.35996336250763283
343,swap,11885.0,425,12,26,3,38,0.35996336250763283
344,swap,11885.0,425,12,26,3,38,0.35996336250763283
345,swap,11885.0,425,12,26,3,38,0.35996336250763283
346,swap,11885.0,425,12,26,3,38,0.35996336250763283
347,swap,11885.0,425,12,26,3,38,0.35996336250763283
348,swap,11885.0,425,12,26,3,38,0.35996336250763283
349,swap,11885.0,425,12,26,3,38,0.35996336250763283
350,swap,11885.0,425,12,26,3,38,0.35996336250763283
351,swap,11885.0,425,12,26,3,38,0.35996336250763283
352,swap,11885.0,425,12,26,3,38,0.35996336250763283
353,swap,11885.0,425,12,26,3,38,0.35996336250763283
354,swap,11885.0,425,12,26,3,38,0.35996336250763283
355,swap,11885.0,425,12,26,3,38,0.35996336250763283
356,swap,11885.0,425,12,26,3,38,0.35996336250763283
357,swap,11884.0,424,12,26,3,38,0.3563894523326572
358,swap,11884.0,424,12,26,3,38,0.3563894523326572
359,swap,11884.0,424,12,26,3,38,0.3563894523326572
360,reassign,11581.0,421,11,26,3,37,0.3552499498092753
361,swap,11581.0,421,11,26,3,37,0.3552499498092753
362,swap,11581.0,421,11,26,3,37,0.3552499498092753
363,swap,11581.0,421,11,26,3,37,0.3552499498092753
364,reassign,11580.0,420,11,26,3,37,0.354875283446712
365,mut_micro,11580.0,420,11,26,3,37,0.354875283446712
366,mut_micro,11580.0,420,11,26,3,37,0.354875283446712
367,swap,11580.0,420,11,26,3,37,0.354875283446712
368,swap,11580.0,420,11,26,3,37,0.354875283446712
369,swap,11580.0,420,11,26,3,37,0.354875283446712
370,swap,11580.0,420,11,26,3,37,0.354875283446712
371,swap,11580.0,420,11,26,3,37,0.354875283446712
372,swap,11580.0,420,11,26,3,37,0.354875283446712
373,swap,11580.0,420,11,26,3,37,0.354875283446712
374,swap,11580.0,420,11,26,3,37,0.354875283446712
375,swap,11580.0,420,11,26,3,37,0.354875283446712
376,swap,11580.0,420,11,26,3,37,0.354875283446712
377,swap,11580.0,420,11,26,3,37,0.354875283446712
378,swap,11580.0,420,11,26,3,37,0.354875283446712
379,swap,11580.0,420,11,26,3,37,0.354875283446712
380,mut_micro,11580.0,420,11,26,3,37,0.354875283446712
381,reassign,11576.0,416,11,26,3,37,0.35155941571259375
382,swap,11576.0,416,11,26,3,37,0.35155941571259375
383,swap,11576.0,416,11,26,3,37,0.35155941571259375
384,swap,11576.0,416,11,26,3,37,0.35155941571259375
385,swap,11574.0,414,11,26,3,37,0.35137254901960785
386,swap,11574.0,414,11,26,3,37,0.35137254901960785
387,swap,11574.0,414,11,26,3,37,0.35137254901960785
388,swap,11574.0,414,11,26,3,37,0.35137254901960785
389,swap,11574.0,414,11,26,3,37,0.35137254901960785
390,swap,11574.0,414,11,26,3,37,0.35137254901960785
391,swap,11574.0,414,11,26,3,37,0.35137254901960785
392,swap,11574.0,414,11,26,3,37,0.35137254901960785
393,swap,11574.0,414,11,26,3,37,0.35137254901960785
394,swap,11574.0,414,11,26,3,37,0.35137254901960785
395,swap,11574.0,414,11,26,3,37,0.35137254901960785
396,swap,11574.0,414,11,26,3,37,0.35137254901960785
397,swap,11570.0,410,11,26,3,37,0.347781217750258
398,swap,11570.0,410,11,26,3,37,0.347781217750258
399,swap,11570.0,410,11,26,3,37,0.347781217750258
400,swap,11568.0,408,11,26,3,37,0.34441881327694474
401,swap,11568.0,408,11,26,3,37,0.34441881327694474
402,swap,11568.0,408,11,26,3,37,0.34441881327694474
403,swap,11568.0,408,11,26,3,37,0.34441881327694474
404,swap,11568.0,408,11,26,3,37,0.34441881327694474
405,swap,11568.0,408,11,26,3,37,0.34441881327694474
406,swap,11568.0,408,11,26,3,37,0.34441881327694474
407,swap,11568.0,408,11,26,3,37,0.34441881327694474
408,swap,11568.0,408,11,26,3,37,0.34441881327694474
409,swap,11568.0,408,11,26,3,37,0.34441881327694474
410,swap,11568.0,408,11,26,3,37,0.34441881327694474
411,swap,11568.0,408,11,26,3,37,0.34441881327694474
412,swap,11568.0,408,11,26,3,37,0.34441881327694474
413,swap,11568.0,408,11,26,3,37,0.34441881327694474
414,swap,11568.0,408,11,26,3,37,0.34441881327694474
415,reassign,11568.0,408,11,26,3,37,0.34441881327694474
416,swap,11568.0,408,11,26,3,37,0.34441881327694474
417,swap,11568.0,408,11,26,3,37,0.34441881327694474
418,swap,11568.0,408,11,26,3,37,0.34441881327694474
419,swap,11568.0,408,11,26,3,37,0.34441881327694474
420,swap,11568.0,408,11,26,3,37,0.34441881327694474
421,swap,11568.0,408,11,26,3,37,0.34441881327694474
422,swap,11568.0,408,11,26,3,37,0.34441881327694474
423,swap,11568.0,408,11,26,3,37,0.34441881327694474
424,reassign,11568.0,408,11,26,3,37,0.34441881327694474
425,swap,11568.0,408,11,26,3,37,0.34441881327694474
426,swap,11568.0,408,11,26,3,37,0.34441881327694474
427,swap,11568.0,408,11,26,3,37,0.34441881327694474
428,mut_micro,11568.0,408,11,26,3,37,0.34441881327694474
429,swap,11568.0,408,11,26,3,37,0.34441881327694474
430,swap,11568.0,408,11,26,3,37,0.34441881327694474
431,swap,11568.0,408,11,26,3,37,0.34441881327694474
432,swap,11568.0,408,11,26,3,37,0.34441881327694474
433,swap,11568.0,408,11,26,3,37,0.34441881327694474
434,swap,11568.0,408,11,26,3,37,0.34441881327694474
435,swap,11568.0,408,11,26,3,37,0.34441881327694474
436,swap,11568.0,408,11,26,3,37,0.34441881327694474
437,swap,11568.0,408,11,26,3,37,0.34441881327694474
438,swap,11568.0,408,11,26,3,37,0.34441881327694474
439,swap,11568.0,408,11,26,3,37,0.34441881327694474
440,swap,11568.0,408,11,26,3,37,0.34441881327694474
441,swap,11276.0,416,11,25,3,36,0.35044084747993154
442,swap,11276.0,416,11,25,3,36,0.35044084747993154
443,swap,11276.0,416,11,25,3,36,0.35044084747993154
444,swap,11276.0,416,11,25,3,36,0.35044084747993154
445,swap,11276.0,416,11,25,3,36,0.35044084747993154
446,reassign,11276.0,416,11,25,3,36,0.35044084747993154
447,swap,11276.0,416,11,25,3,36,0.35044084747993154
448,swap,11276.0,416,11,25,3,36,0.35044084747993154
449,swap,11276.0,416,11,25,3,36,0.35044084747993154
450,swap,11276.0,416,11,25,3,36,0.35044084747993154
451,swap,11276.0,416,11,25,3,36,0.35044084747993154
452,swap,11276.0,416,11,25,3,36,0.35044084747993154
453,swap,11276.0,416,11,25,3,36,0.35044084747993154
454,swap,11276.0,416,11,25,3,36,0.35044084747993154
455,swap,11276.0,416,11,25,3,36,0.35044084747993154
456,swap,11276.0,416,11,25,3,36,0.35044084747993154
457,swap,11276.0,416,11,25,3,36,0.35044084747993154
458,swap,11276.0,416,11,25,3,36,0.35044084747993154
459,swap,11276.0,416,11,25,3,36,0.35044084747993154
460,swap,11276.0,416,11,25,3,36,0.35044084747993154
461,swap,11276.0,416,11,25,3,36,0.35044084747993154
462,swap,11276.0,416,11,25,3,36,0.35044084747993154
463,swap,11276.0,416,11,25,3,36,0.35044084747993154
464,swap,11276.0,416,11,25,3,36,0.35044084747993154
465,reassign,11276.0,416,11,25,3,36,0.35044084747993154
466,swap,11276.0,416,11,25,3,36,0.35044084747993154
467,reassign,11276.0,416,11,25,3,36,0.35044084747993154
468,swap,11276.0,416,11,25,3,36,0.35044084747993154
469,swap,11276.0,416,11,25,3,36,0.35044084747993154
470,swap,11276.0,416,11,25,3,36,0.35044084747993154
471,swap,11276.0,416,11,25,3,36,0.35044084747993154
472,swap,10973.0,413,11,24,3,35,0.34665494104618594
473,swap,10973.0,413,11,24,3,35,0.34665494104618594
474,swap,10973.0,413,11,24,3,35,0.34665494104618594
475,swap,10973.0,413,11,24,3,35,0.34665494104618594
476,mut_micro,10973.0,413,11,24,3,35,0.34665494104618594
477,swap,10973.0,413,11,24,3,35,0.34665494104618594
478,swap,10973.0,413,11,24,3,35,0.34665494104618594
479,swap,10973.0,413,11,24,3,35,0.34665494104618594
480,swap,10973.0,413,11,24,3,35,0.34665494104618594
481,swap,10973.0,413,11,24,3,35,0.34665494104618594
482,swap,10973.0,413,11,24,3,35,0.34665494104618594
483,swap,10973.0,413,11,24,3,35,0.34665494104618594
484,swap,10973.0,413,11,24,3,35,0.34665494104618594
485,swap,10973.0,413,11,24,3,35,0.34665494104618594
486,swap,10973.0,413,11,24,3,35,0.34665494104618594
487,swap,10973.0,413,11,24,3,35,0.34665494104618594
488,swap,10973.0,413,11,24,3,35,0.34665494104618594
489,swap,10973.0,413,11,24,3,35,0.34665494104618594
490,swap,10973.0,413,11,24,3,35,0.34665494104618594
491,swap,10973.0,413,11,24,3,35,0.34665494104618594
492,mut_micro,10973.0,413,11,24,3,35,0.34665494104618594
493,swap,10973.0,413,11,24,3,35,0.34665494104618594
494,swap,10973.0,413,11,24,3,35,0.34665494104618594
495,swap,10973.0,413,11,24,3,35,0.34665494104618594
496,swap,10973.0,413,11,24,3,35,0.34665494104618594
497,swap,10973.0,413,11,24,3,35,0.34665494104618594
498,swap,10973.0,413,11,24,3,35,0.34665494104618594
499,swap,10973.0,413,11,24,3,35,0.34665494104618594
500,swap,10973.0,413,11,24,3,35,0.34665494104618594
501,swap,10973.0,413,11,24,3,35,0.34665494104618594
502,swap,10973.0,413,11,24,3,35,0.34665494104618594
503,swap,10973.0,413,11,24,3,35,0.34665494104618594
504,swap,10973.0,413,11,24,3,35,0.34665494104618594
505,swap,10973.0,413,11,24,3,35,0.34665494104618594
506,swap,10973.0,413,11,24,3,35,0.34665494104618594
507,swap,10973.0,413,11,24,3,35,0.34665494104618594
508,swap,10973.0,413,11,24,3,35,0.34665494104618594
509,swap,10973.0,413,11,24,3,35,0.34665494104618594
510,swap,10973.0,413,11,24,3,35,0.34665494104618594
511,swap,10973.0,413,11,24,3,35,0.34665494104618594
512,swap,10973.0,413,11,24,3,35,0.34665494104618594
513,swap,10973.0,413,11,24,3,35,0.34665494104618594
514,swap,10973.0,413,11,24,3,35,0.34665494104618594
515,swap,10973.0,413,11,24,3,35,0.34665494104618594
516,swap,10973.0,413,11,24,3,35,0.34665494104618594
517,swap,10973.0,413,11,24,3,35,0.34665494104618594
518,swap,10973.0,413,11,24,3,35,0.34665494104618594
519,swap,10973.0,413,11,24,3,35,0.34665494104618594
520,swap,10973.0,413,11,24,3,35,0.34665494104618594
521,swap,10973.0,413,11,24,3,35,0.34665494104618594
522,swap,10973.0,413,11,24,3,35,0.34665494104618594
523,swap,10973.0,413,11,24,3,35,0.34665494104618594
524,mut_micro,10969.0,409,11,24,3,35,0.3430086788813887
525,swap,10969.0,409,11,24,3,35,0.3430086788813887
526,swap,10678.0,418,11,23,3,34,0.3486354001059883
527,swap,10678.0,418,11,23,3,34,0.3486354001059883
528,swap,10678.0,418,11,23,3,34,0.3486354001059883
529,swap,10678.0,418,11,23,3,34,0.3486354001059883
530,swap,10678.0,418,11,23,3,34,0.3486354001059883
531,swap,10678.0,418,11,23,3,34,0.3486354001059883
532,swap,10678.0,418,11,23,3,34,0.3486354001059883
533,swap,10678.0,418,11,23,3,34,0.3486354001059883
534,swap,10678.0,418,11,23,3,34,0.3486354001059883
535,swap,10678.0,418,11,23,3,34,0.3486354001059883
536,swap,10678.0,418,11,23,3,34,0.3486354001059883
537,swap,10678.0,418,11,23,3,34,0.3486354001059883
538,swap,10678.0,418,11,23,3,34,0.3486354001059883
539,swap,10678.0,418,11,23,3,34,0.3486354001059883
540,swap,10678.0,418,11,23,3,34,0.3486354001059883
541,swap,10678.0,418,11,23,3,34,0.3486354001059883
542,swap,10678.0,418,11,23,3,34,0.3486354001059883
543,swap,10678.0,418,11,23,3,34,0.3486354001059883
544,swap,10678.0,418,11,23,3,34,0.3486354001059883
545,swap,10678.0,418,11,23,3,34,0.3486354001059883
546,swap,10678.0,418,11,23,3,34,0.3486354001059883
547,swap,10678.0,418,11,23,3,34,0.3486354001059883
548,swap,10678.0,418,11,23,3,34,0.3486354001059883
549,swap,10678.0,418,11,23,3,34,0.3486354001059883
550,mut_micro,10678.0,418,11,23,3,34,0.3486354001059883
551,swap,10678.0,418,11,23,3,34,0.3486354001059883
552,swap,10678.0,418,11,23,3,34,0.3486354001059883
553,swap,10678.0,418,11,23,3,34,0.3486354001059883
554,swap,10678.0,418,11,23,3,34,0.3486354001059883
555,swap,10678.0,418,11,23,3,34,0.3486354001059883
556,swap,10678.0,418,11,23,3,34,0.3486354001059883
557,swap,10678.0,418,11,23,3,34,0.3486354001059883
558,swap,10678.0,418,11,23,3,34,0.3486354001059883
559,swap,10678.0,418,11,23,3,34,0.3486354001059883
560,swap,10678.0,418,11,23,3,34,0.3486354001059883
561,swap,10678.0,418,11,23,3,34,0.3486354001059883
562,swap,10678.0,418,11,23,3,34,0.3486354001059883
563,swap,10678.0,418,11,23,3,34,0.3486354001059883
564,swap,10678.0,418,11,23,3,34,0.3486354001059883
565,swap,10678.0,418,11,23,3,34,0.3486354001059883
566,swap,10678.0,418,11,23,3,34,0.3486354001059883
567,swap,10678.0,418,11,23,3,34,0.3486354001059883
568,swap,10678.0,418,11,23,3,34,0.3486354001059883
569,reassign,10678.0,418,11,23,3,34,0.3486354001059883
570,swap,10678.0,418,11,23,3,34,0.3486354001059883
571,swap,10678.0,418,11,23,3,34,0.3486354001059883
572,swap,10678.0,418,11,23,3,34,0.3486354001059883
573,swap,10678.0,418,11,23,3,34,0.3486354001059883
574,swap,10678.0,418,11,23,3,34,0.3486354001059883
575,mut_micro,10678.0,418,11,23,3,34,0.3486354001059883
576,swap,10678.0,418,11,23,3,34,0.3486354001059883
577,swap,10678.0,418,11,23,3,34,0.3486354001059883
578,swap,10678.0,418,11,23,3,34,0.3486354001059883
579,swap,10678.0,418,11,23,3,34,0.3486354001059883
580,swap,10678.0,418,11,23,3,34,0.3486354001059883
581,swap,10678.0,418,11,23,3,34,0.3486354001059883
582,reassign,10678.0,418,11,23,3,34,0.3486354001059883
583,swap,10678.0,418,11,23,3,34,0.3486354001059883
584,swap,10678.0,418,11,23,3,34,0.3486354001059883
585,swap,10678.0,418,11,23,3,34,0.3486354001059883
586,swap,10678.0,418,11,23,3,34,0.3486354001059883
587,swap,10678.0,418,11,23,3,34,0.3486354001059883
588,swap,10678.0,418,11,23,3,34,0.3486354001059883
589,swap,10678.0,418,11,23,3,34,0.3486354001059883
590,swap,10678.0,418,11,23,3,34,0.3486354001059883
591,swap,10678.0,418,11,23,3,34,0.3486354001059883
592,swap,10678.0,418,11,23,3,34,0.3486354001059883
593,swap,10678.0,418,11,23,3,34,0.3486354001059883
594,mut_micro,10678.0,418,11,23,3,34,0.3486354001059883
595,swap,10678.0,418,11,23,3,34,0.3486354001059883
596,swap,10678.0,418,11,23,3,34,0.3486354001059883
597,swap,10678.0,418,11,23,3,34,0.3486354001059883
598,swap,10678.0,418,11,23,3,34,0.3486354001059883
599,swap,10678.0,418,11,23,3,34,0.3486354001059883
600,swap,10678.0,418,11,23,3,34,0.3486354001059883
601,swap,10677.0,417,11,23,3,34,0.34663629761668974
602,swap,10677.0,417,11,23,3,34,0.34663629761668974
603,swap,10677.0,417,11,23,3,34,0.34663629761668974
604,swap,10677.0,417,11,23,3,34,0.34663629761668974
605,reassign,10677.0,417,11,23,3,34,0.34663629761668974
606,swap,10677.0,417,11,23,3,34,0.34663629761668974
607,swap,10677.0,417,11,23,3,34,0.34663629761668974
608,swap,10677.0,417,11,23,3,34,0.34663629761668974
609,swap,10676.0,416,11,23,3,34,0.34530859323595203
610,swap,10376.0,416,11,22,3,33,0.34530859323595203
611,swap,10376.0,416,11,22,3,33,0.34530859323595203
612,swap,10376.0,416,11,22,3,33,0.34530859323595203
613,swap,10376.0,416,11,22,3,33,0.34530859323595203
614,reassign,10376.0,416,11,22,3,33,0.34530859323595203
615,reassign,10358.0,418,11,22,2,33,0.34532326444091144
616,swap,10358.0,418,11,22,2,33,0.34532326444091144
617,reassign,10358.0,418,11,22,2,33,0.34532326444091144
618,swap,10358.0,418,11,22,2,33,0.34532326444091144
619,swap,10358.0,418,11,22,2,33,0.34532326444091144
620,swap,10358.0,418,11,22,2,33,0.34532326444091144
621,swap,10358.0,418,11,22,2,33,0.34532326444091144
622,swap,10358.0,418,11,22,2,33,0.34532326444091144
623,swap,10358.0,418,11,22,2,33,0.34532326444091144
624,swap,10358.0,418,11,22,2,33,0.34532326444091144
625,swap,10358.0,418,11,22,2,33,0.34532326444091144
626,swap,10358.0,418,11,22,2,33,0.34532326444091144
627,swap,10358.0,418,11,22,2,33,0.34532326444091144
628,swap,10358.0,418,11,22,2,33,0.34532326444091144
629,swap,10358.0,418,11,22,2,33,0.34532326444091144
630,swap,10351.0,411,11,22,2,33,0.3399016372225458
631,swap,10060.0,420,11,21,2,32,0.3452047485660932
632,swap,10060.0,420,11,21,2,32,0.3452047485660932
633,swap,10060.0,420,11,21,2,32,0.3452047485660932
634,swap,10060.0,420,11,21,2,32,0.3452047485660932
635,swap,10060.0,420,11,21,2,32,0.3452047485660932
636,swap,10060.0,420,11,21,2,32,0.3452047485660932
637,swap,10060.0,420,11,21,2,32,0.3452047485660932
638,swap,10060.0,420,11,21,2,32,0.3452047485660932
639,swap,10060.0,420,11,21,2,32,0.3452047485660932
640,reassign,9765.0,425,10,21,2,31,0.3467331569305923
641,swap,9765.0,425,10,21,2,31,0.3467331569305923
642,swap,9765.0,425,10,21,2,31,0.3467331569305923
643,swap,9765.0,425,10,21,2,31,0.3467331569305923
644,swap,9765.0,425,10,21,2,31,0.3467331569305923
645,swap,9765.0,425,10,21,2,31,0.3467331569305923
646,swap,9765.0,425,10,21,2,31,0.3467331569305923
647,swap,9765.0,425,10,21,2,31,0.3467331569305923
648,swap,9765.0,425,10,21,2,31,0.3467331569305923
649,swap,9765.0,425,10,21,2,31,0.3467331569305923
650,swap,9765.0,425,10,21,2,31,0.3467331569305923
651,swap,9765.0,425,10,21,2,31,0.3467331569305923
652,swap,9765.0,425,10,21,2,31,0.3467331569305923
653,swap,9765.0,425,10,21,2,31,0.3467331569305923
654,swap,9765.0,425,10,21,2,31,0.3467331569305923
655,swap,9765.0,425,10,21,2,31,0.3467331569305923
656,swap,9765.0,425,10,21,2,31,0.3467331569305923
657,swap,9765.0,425,10,21,2,31,0.3467331569305923
658,swap,9765.0,425,10,21,2,31,0.3467331569305923
659,swap,9765.0,425,10,21,2,31,0.3467331569305923
660,swap,9765.0,425,10,21,2,31,0.3467331569305923
661,swap,9765.0,425,10,21,2,31,0.3467331569305923
662,swap,9765.0,425,10,21,2,31,0.3467331569305923
663,swap,9765.0,425,10,21,2,31,0.3467331569305923
664,swap,9765.0,425,10,21,2,31,0.3467331569305923
665,swap,9765.0,425,10,21,2,31,0.3467331569305923
666,reassign,9765.0,425,10,21,2,31,0.3467331569305923
667,swap,9765.0,425,10,21,2,31,0.3467331569305923
668,swap,9765.0,425,10,21,2,31,0.3467331569305923
669,swap,9765.0,425,10,21,2,31,0.3467331569305923
670,swap,9765.0,425,10,21,2,31,0.3467331569305923
671,swap,9765.0,425,10,21,2,31,0.3467331569305923
672,swap,9765.0,425,10,21,2,31,0.3467331569305923
673,swap,9765.0,425,10,21,2,31,0.3467331569305923
674,swap,9765.0,425,10,21,2,31,0.3467331569305923
675,swap,9765.0,425,10,21,2,31,0.3467331569305923
676,swap,9765.0,425,10,21,2,31,0.3467331569305923
677,swap,9765.0,425,10,21,2,31,0.3467331569305923
678,swap,9765.0,425,10,21,2,31,0.3467331569305923
679,swap,9765.0,425,10,21,2,31,0.3467331569305923
680,swap,9765.0,425,10,21,2,31,0.3467331569305923
681,swap,9765.0,425,10,21,2,31,0.3467331569305923
682,swap,9765.0,425,10,21,2,31,0.3467331569305923
683,swap,9765.0,425,10,21,2,31,0.3467331569305923
684,swap,9765.0,425,10,21,2,31,0.3467331569305923
685,swap,9765.0,425,10,21,2,31,0.3467331569305923
686,mut_micro,9765.0,425,10,21,2,31,0.3467331569305923
687,reassign,9765.0,425,10,21,2,31,0.3467331569305923
688,swap,9765.0,425,10,21,2,31,0.3467331569305923
689,swap,9765.0,425,10,21,2,31,0.3467331569305923
690,reassign,9765.0,425,10,21,2,31,0.3467331569305923
691,swap,9765.0,425,10,21,2,31,0.3467331569305923
692,swap,9765.0,425,10,21,2,31,0.3467331569305923
693,swap,9765.0,425,10,21,2,31,0.3467331569305923
694,swap,9765.0,425,10,21,2,31,0.3467331569305923
695,swap,9765.0,425,10,21,2,31,0.3467331569305923
696,swap,9765.0,425,10,21,2,31,0.3467331569305923
697,swap,9765.0,425,10,21,2,31,0.3467331569305923
698,mut_micro,9765.0,425,10,21,2,31,0.3467331569305923
699,swap,9765.0,425,10,21,2,31,0.3467331569305923
700,swap,9765.0,425,10,21,2,31,0.3467331569305923
701,swap,9765.0,425,10,21,2,31,0.3467331569305923
702,swap,9765.0,425,10,21,2,31,0.3467331569305923
703,swap,9765.0,425,10,21,2,31,0.3467331569305923
704,swap,9765.0,425,10,21,2,31,0.3467331569305923
705,swap,9765.0,425,10,21,2,31,0.3467331569305923
706,swap,9765.0,425,10,21,2,31,0.3467331569305923
707,swap,9765.0,425,10,21,2,31,0.3467331569305923
708,swap,9765.0,425,10,21,2,31,0.3467331569305923
709,mut_micro,9765.0,425,10,21,2,31,0.3467331569305923
710,swap,9765.0,425,10,21,2,31,0.3467331569305923
711,swap,9765.0,425,10,21,2,31,0.3467331569305923
712,swap,9765.0,425,10,21,2,31,0.3467331569305923
713,swap,9765.0,425,10,21,2,31,0.3467331569305923
714,swap,9765.0,425,10,21,2,31,0.3467331569305923
715,swap,9765.0,425,10,21,2,31,0.3467331569305923
716,swap,9765.0,425,10,21,2,31,0.3467331569305923
717,swap,9765.0,425,10,21,2,31,0.3467331569305923
718,swap,9765.0,425,10,21,2,31,0.3467331569305923
719,swap,9765.0,425,10,21,2,31,0.3467331569305923
720,swap,9765.0,425,10,21,2,31,0.3467331569305923
721,swap,9765.0,425,10,21,2,31,0.3467331569305923
722,swap,9765.0,425,10,21,2,31,0.3467331569305923
723,swap,9765.0,425,10,21,2,31,0.3467331569305923
724,swap,9765.0,425,10,21,2,31,0.3467331569305923
725,swap,9765.0,425,10,21,2,31,0.3467331569305923
726,swap,9765.0,425,10,21,2,31,0.3467331569305923
727,swap,9765.0,425,10,21,2,31,0.3467331569305923
728,swap,9763.0,423,10,21,2,31,0.34333939761471605
729,swap,9763.0,423,10,21,2,31,0.34333939761471605
730,swap,9763.0,423,10,21,2,31,0.34333939761471605
731,swap,9763.0,423,10,21,2,31,0.34333939761471605
732,swap,9763.0,423,10,21,2,31,0.34333939761471605
733,swap,9763.0,423,10,21,2,31,0.34333939761471605
734,swap,9763.0,423,10,21,2,31,0.34333939761471605
735,swap,9763.0,423,10,21,2,31,0.34333939761471605
736,reassign,9763.0,423,10,21,2,31,0.34333939761471605
737,swap,9763.0,423,10,21,2,31,0.34333939761471605
738,swap,9763.0,423,10,21,2,31,0.34333939761471605
739,swap,9763.0,423,10,21,2,31,0.34333939761471605
740,swap,9763.0,423,10,21,2,31,0.34333939761471605
741,swap,9763.0,423,10,21,2,31,0.34333939761471605
742,swap,9763.0,423,10,21,2,31,0.34333939761471605
743,swap,9763.0,423,10,21,2,31,0.34333939761471605
744,swap,9763.0,423,10,21,2,31,0.34333939761471605
745,swap,9763.0,423,10,21,2,31,0.34333939761471605
746,swap,9763.0,423,10,21,2,31,0.34333939761471605
747,swap,9763.0,423,10,21,2,31,0.34333939761471605
748,swap,9763.0,423,10,21,2,31,0.34333939761471605
749,swap,9763.0,423,10,21,2,31,0.34333939761471605
750,swap,9763.0,423,10,21,2,31,0.34333939761471605
751,swap,9763.0,423,10,21,2,31,0.34333939761471605
752,swap,9763.0,423,10,21,2,31,0.34333939761471605
753,swap,9763.0,423,10,21,2,31,0.34333939761471605
754,mut_micro,9763.0,423,10,21,2,31,0.34333939761471605
755,swap,9761.0,421,10,21,2,31,0.34360570166633214
756,swap,9761.0,421,10,21,2,31,0.34360570166633214
757,swap,9761.0,421,10,21,2,31,0.34360570166633214
758,swap,9761.0,421,10,21,2,31,0.34360570166633214
759,swap,9756.0,416,10,21,2,31,0.3418870904066325
760,swap,9756.0,416,10,21,2,31,0.3418870904066325
761,swap,9756.0,416,10,21,2,31,0.3418870904066325
762,swap,9756.0,416,10,21,2,31,0.3418870904066325
763,swap,9756.0,416,10,21,2,31,0.3418870904066325
764,swap,9756.0,416,10,21,2,31,0.3418870904066325
765,swap,9756.0,416,10,21,2,31,0.3418870904066325
766,swap,9756.0,416,10,21,2,31,0.3418870904066325
767,swap,9756.0,416,10,21,2,31,0.3418870904066325
768,swap,9756.0,416,10,21,2,31,0.3418870904066325
769,swap,9756.0,416,10,21,2,31,0.3418870904066325
770,swap,9756.0,416,10,21,2,31,0.3418870904066325
771,swap,9756.0,416,10,21,2,31,0.3418870904066325
772,swap,9756.0,416,10,21,2,31,0.3418870904066325
773,swap,9756.0,416,10,21,2,31,0.3418870904066325
774,reassign,9732.0,412,10,21,1,31,0.3383976106999091
775,swap,9732.0,412,10,21,1,31,0.3383976106999091
776,swap,9732.0,412,10,21,1,31,0.3383976106999091
777,swap,9732.0,412,10,21,1,31,0.3383976106999091
778,swap,9732.0,412,10,21,1,31,0.3383976106999091
779,swap,9732.0,412,10,21,1,31,0.3383976106999091
780,swap,9732.0,412,10,21,1,31,0.3383976106999091
781,reassign,9729.0,409,11,20,1,31,0.33439408550305366
782,swap,9729.0,409,11,20,1,31,0.33439408550305366
783,swap,9729.0,409,11,20,1,31,0.33439408550305366
784,swap,9729.0,409,11,20,1,31,0.33439408550305366
785,swap,9729.0,409,11,20,1,31,0.33439408550305366
786,swap,9729.0,409,11,20,1,31,0.33439408550305366
787,swap,9729.0,409,11,20,1,31,0.33439408550305366
788,swap,9729.0,409,11,20,1,31,0.33439408550305366
789,swap,9729.0,409,11,20,1,31,0.33439408550305366
790,swap,9729.0,409,11,20,1,31,0.33439408550305366
791,swap,9729.0,409,11,20,1,31,0.33439408550305366
792,swap,9729.0,409,11,20,1,31,0.33439408550305366
793,swap,9729.0,409,11,20,1,31,0.33439408550305366
794,swap,9729.0,409,11,20,1,31,0.33439408550305366
795,swap,9729.0,409,11,20,1,31,0.33439408550305366
796,swap,9729.0,409,11,20,1,31,0.33439408550305366
797,swap,9729.0,409,11,20,1,31,0.33439408550305366
798,swap,9729.0,409,11,20,1,31,0.33439408550305366
799,swap,9729.0,409,11,20,1,31,0.33439408550305366
800,swap,9729.0,409,11,20,1,31,0.33439408550305366
801,swap,9729.0,409,11,20,1,31,0.33439408550305366
802,swap,9729.0,409,11,20,1,31,0.33439408550305366
803,swap,9729.0,409,11,20,1,31,0.33439408550305366
804,swap,9729.0,409,11,20,1,31,0.33439408550305366
805,swap,9729.0,409,11,20,1,31,0.33439408550305366
806,swap,9727.0,407,11,20,1,31,0.330746630899917
807,swap,9727.0,407,11,20,1,31,0.330746630899917
808,swap,9727.0,407,11,20,1,31,0.330746630899917
809,swap,9727.0,407,11,20,1,31,0.330746630899917
810,swap,9727.0,407,11,20,1,31,0.330746630899917
811,mut_micro,9727.0,407,11,20,1,31,0.330746630899917
812,swap,9727.0,407,11,20,1,31,0.330746630899917
813,swap,9433.0,413,11,19,1,30,0.3349293205654355
814,swap,9433.0,413,11,19,1,30,0.3349293205654355
815,swap,9433.0,413,11,19,1,30,0.3349293205654355
816,reassign,9433.0,413,11,19,1,30,0.3349293205654355
817,swap,9433.0,413,11,19,1,30,0.3349293205654355
818,swap,9433.0,413,11,19,1,30,0.3349293205654355
819,swap,9433.0,413,11,19,1,30,0.3349293205654355
820,swap,9433.0,413,11,19,1,30,0.3349293205654355
821,swap,9433.0,413,11,19,1,30,0.3349293205654355
822,swap,9134.0,414,11,18,1,29,0.33699346405228775
823,swap,9134.0,414,11,18,1,29,0.33699346405228775
824,swap,9134.0,414,11,18,1,29,0.33699346405228775
825,reassign,9130.0,410,11,18,1,29,0.33339783281733737
826,swap,9130.0,410,11,18,1,29,0.33339783281733737
827,swap,9130.0,410,11,18,1,29,0.33339783281733737
828,swap,9130.0,410,11,18,1,29,0.33339783281733737
829,swap,9130.0,410,11,18,1,29,0.33339783281733737
830,swap,9130.0,410,11,18,1,29,0.33339783281733737
831,swap,9130.0,410,11,18,1,29,0.33339783281733737
832,swap,9130.0,410,11,18,1,29,0.33339783281733737
833,swap,9130.0,410,11,18,1,29,0.33339783281733737
834,swap,9130.0,410,11,18,1,29,0.33339783281733737
835,swap,9130.0,410,11,18,1,29,0.33339783281733737
836,swap,9130.0,410,11,18,1,29,0.33339783281733737
837,swap,9129.0,409,11,18,1,29,0.33130826100932176
838,swap,9129.0,409,11,18,1,29,0.33130826100932176
839,swap,9129.0,409,11,18,1,29,0.33130826100932176
840,swap,9129.0,409,11,18,1,29,0.33130826100932176
841,swap,9129.0,409,11,18,1,29,0.33130826100932176
842,swap,9129.0,409,11,18,1,29,0.33130826100932176
843,swap,9129.0,409,11,18,1,29,0.33130826100932176
844,swap,8836.0,416,11,17,1,28,0.3388603763653113
845,swap,8836.0,416,11,17,1,28,0.3388603763653113
846,swap,8836.0,416,11,17,1,28,0.3388603763653113
847,swap,8836.0,416,11,17,1,28,0.3388603763653113
848,swap,8836.0,416,11,17,1,28,0.3388603763653113
849,swap,8835.0,415,11,17,1,28,0.3404485540035413
850,swap,8835.0,415,11,17,1,28,0.3404485540035413
851,swap,8835.0,415,11,17,1,28,0.3404485540035413
852,swap,8835.0,415,11,17,1,28,0.3404485540035413
853,swap,8835.0,415,11,17,1,28,0.3404485540035413
854,swap,8835.0,415,11,17,1,28,0.3404485540035413
855,swap,8835.0,415,11,17,1,28,0.3404485540035413
856,swap,8834.0,414,11,17,1,28,0.3454248366013072
857,swap,8834.0,414,11,17,1,28,0.3454248366013072
858,swap,8834.0,414,11,17,1,28,0.3454248366013072
859,swap,8834.0,414,11,17,1,28,0.3454248366013072
860,mut_micro,8834.0,414,11,17,1,28,0.3454248366013072
861,swap,8834.0,414,11,17,1,28,0.3454248366013072
862,swap,8834.0,414,11,17,1,28,0.3454248366013072
863,swap,8834.0,414,11,17,1,28,0.3454248366013072
864,swap,8834.0,414,11,17,1,28,0.3454248366013072
865,swap,8834.0,414,11,17,1,28,0.3454248366013072
866,mut_micro,8834.0,414,11,17,1,28,0.3454248366013072
867,swap,8834.0,414,11,17,1,28,0.3454248366013072
868,swap,8834.0,414,11,17,1,28,0.3454248366013072
869,swap,8834.0,414,11,17,1,28,0.3454248366013072
870,swap,8834.0,414,11,17,1,28,0.3454248366013072
871,swap,8834.0,414,11,17,1,28,0.3454248366013072
872,swap,8834.0,414,11,17,1,28,0.3454248366013072
873,swap,8834.0,414,11,17,1,28,0.3454248366013072
874,swap,8834.0,414,11,17,1,28,0.3454248366013072
875,swap,8834.0,414,11,17,1,28,0.3454248366013072
876,reassign,8834.0,414,11,17,1,28,0.3454248366013072
877,swap,8834.0,414,11,17,1,28,0.3454248366013072
878,swap,8834.0,414,11,17,1,28,0.3454248366013072
879,swap,8834.0,414,11,17,1,28,0.3454248366013072
880,swap,8834.0,414,11,17,1,28,0.3454248366013072
881,swap,8834.0,414,11,17,1,28,0.3454248366013072
882,swap,8834.0,414,11,17,1,28,0.3454248366013072
883,swap,8834.0,414,11,17,1,28,0.3454248366013072
884,swap,8834.0,414,11,17,1,28,0.3454248366013072
885,swap,8834.0,414,11,17,1,28,0.3454248366013072
886,swap,8834.0,414,11,17,1,28,0.3454248366013072
887,swap,8834.0,414,11,17,1,28,0.3454248366013072
888,swap,8834.0,414,11,17,1,28,0.3454248366013072
889,swap,8834.0,414,11,17,1,28,0.3454248366013072
890,swap,8834.0,414,11,17,1,28,0.3454248366013072
891,swap,8834.0,414,11,17,1,28,0.3454248366013072
892,swap,8834.0,414,11,17,1,28,0.3454248366013072
893,swap,8834.0,414,11,17,1,28,0.3454248366013072
894,swap,8834.0,414,11,17,1,28,0.3454248366013072
895,swap,8834.0,414,11,17,1,28,0.3454248366013072
896,swap,8834.0,414,11,17,1,28,0.3454248366013072
897,swap,8834.0,414,11,17,1,28,0.3454248366013072
898,swap,8834.0,414,11,17,1,28,0.3454248366013072
899,swap,8834.0,414,11,17,1,28,0.3454248366013072
900,swap,8834.0,414,11,17,1,28,0.3454248366013072
901,swap,8834.0,414,11,17,1,28,0.3454248366013072
902,swap,8834.0,414,11,17,1,28,0.3454248366013072
903,swap,8834.0,414,11,17,1,28,0.3454248366013072
904,swap,8831.0,411,11,17,1,28,0.3466964343493173
905,swap,8831.0,411,11,17,1,28,0.3466964343493173
906,swap,8831.0,411,11,17,1,28,0.3466964343493173
907,swap,8831.0,411,11,17,1,28,0.3466964343493173
908,swap,8825.0,405,11,17,1,28,0.34453328256869087
909,swap,8825.0,405,11,17,1,28,0.34453328256869087
910,swap,8825.0,405,11,17,1,28,0.34453328256869087
911,swap,8825.0,405,11,17,1,28,0.34453328256869087
912,swap,8825.0,405,11,17,1,28,0.34453328256869087
913,swap,8824.0,404,11,17,1,28,0.3425047438330171
914,swap,8824.0,404,11,17,1,28,0.3425047438330171
915,swap,8824.0,404,11,17,1,28,0.3425047438330171
916,swap,8824.0,404,11,17,1,28,0.3425047438330171
917,swap,8824.0,404,11,17,1,28,0.3425047438330171
918,swap,8824.0,404,11,17,1,28,0.3425047438330171
919,swap,8824.0,404,11,17,1,28,0.3425047438330171
920,swap,8824.0,404,11,17,1,28,0.3425047438330171
921,swap,8824.0,404,11,17,1,28,0.3425047438330171
922,swap,8824.0,404,11,17,1,28,0.3425047438330171
923,swap,8824.0,404,11,17,1,28,0.3425047438330171
924,swap,8824.0,404,11,17,1,28,0.3425047438330171
925,swap,8824.0,404,11,17,1,28,0.3425047438330171
926,swap,8824.0,404,11,17,1,28,0.3425047438330171
927,reassign,8824.0,404,11,17,1,28,0.3425047438330171
928,swap,8824.0,404,11,17,1,28,0.3425047438330171
929,swap,8824.0,404,11,17,1,28,0.3425047438330171
930,swap,8824.0,404,11,17,1,28,0.3425047438330171
931,swap,8533.0,413,11,16,1,27,0.34854406879030686
932,swap,8533.0,413,11,16,1,27,0.34854406879030686
933,swap,8533.0,413,11,16,1,27,0.34854406879030686
934,swap,8533.0,413,11,16,1,27,0.34854406879030686
935,swap,8533.0,413,11,16,1,27,0.34854406879030686
936,swap,8533.0,413,11,16,1,27,0.34854406879030686
937,swap,8533.0,413,11,16,1,27,0.34854406879030686
938,swap,8533.0,413,11,16,1,27,0.34854406879030686
939,swap,8533.0,413,11,16,1,27,0.34854406879030686
940,swap,8533.0,413,11,16,1,27,0.34854406879030686
941,swap,8533.0,413,11,16,1,27,0.34854406879030686
942,swap,8533.0,413,11,16,1,27,0.34854406879030686
943,swap,8533.0,413,11,16,1,27,0.34854406879030686
944,swap,8533.0,413,11,16,1,27,0.34854406879030686
945,swap,8533.0,413,11,16,1,27,0.34854406879030686
946,reassign,8213.0,413,10,16,0,26,0.34854406879030686
947,swap,8213.0,413,10,16,0,26,0.34854406879030686
948,swap,8213.0,413,10,16,0,26,0.34854406879030686
949,swap,8213.0,413,10,16,0,26,0.34854406879030686
950,swap,8213.0,413,10,16,0,26,0.34854406879030686
951,swap,8213.0,413,10,16,0,26,0.34854406879030686
952,swap,8213.0,413,10,16,0,26,0.34854406879030686
953,swap,8213.0,413,10,16,0,26,0.34854406879030686
954,swap,8213.0,413,10,16,0,26,0.34854406879030686
955,swap,8213.0,413,10,16,0,26,0.34854406879030686
956,swap,8213.0,413,10,16,0,26,0.34854406879030686
957,swap,8213.0,413,10,16,0,26,0.34854406879030686
958,swap,8213.0,413,10,16,0,26,0.34854406879030686
959,swap,8213.0,413,10,16,0,26,0.34854406879030686
960,swap,8213.0,413,10,16,0,26,0.34854406879030686
961,swap,8213.0,413,10,16,0,26,0.34854406879030686
962,swap,8213.0,413,10,16,0,26,0.34854406879030686
963,swap,8213.0,413,10,16,0,26,0.34854406879030686
964,swap,8213.0,413,10,16,0,26,0.34854406879030686
965,reassign,8213.0,413,10,16,0,26,0.34854406879030686
966,swap,8213.0,413,10,16,0,26,0.34854406879030686
967,swap,8213.0,413,10,16,0,26,0.34854406879030686
968,swap,8213.0,413,10,16,0,26,0.34854406879030686
969,swap,8213.0,413,10,16,0,26,0.34854406879030686
970,swap,8213.0,413,10,16,0,26,0.34854406879030686
971,swap,8213.0,413,10,16,0,26,0.34854406879030686
972,swap,8213.0,413,10,16,0,26,0.34854406879030686
973,swap,8213.0,413,10,16,0,26,0.34854406879030686
974,swap,8213.0,413,10,16,0,26,0.34854406879030686
975,swap,8213.0,413,10,16,0,26,0.34854406879030686
976,swap,8213.0,413,10,16,0,26,0.34854406879030686
977,swap,8213.0,413,10,16,0,26,0.34854406879030686
978,swap,8213.0,413,10,16,0,26,0.34854406879030686
979,swap,8213.0,413,10,16,0,26,0.34854406879030686
980,swap,8213.0,413,10,16,0,26,0.34854406879030686
981,swap,8213.0,413,10,16,0,26,0.34854406879030686
982,swap,8213.0,413,10,16,0,26,0.34854406879030686
983,swap,8213.0,413,10,16,0,26,0.34854406879030686
984,swap,8213.0,413,10,16,0,26,0.34854406879030686
985,swap,8213.0,413,10,16,0,26,0.34854406879030686
986,swap,8213.0,413,10,16,0,26,0.34854406879030686
987,swap,8213.0,413,10,16,0,26,0.34854406879030686
988,swap,8213.0,413,10,16,0,26,0.34854406879030686
989,swap,8213.0,413,10,16,0,26,0.34854406879030686
990,swap,8213.0,413,10,16,0,26,0.34854406879030686
991,swap,8213.0,413,10,16,0,26,0.34854406879030686
992,swap,8213.0,413,10,16,0,26,0.34854406879030686
993,swap,8213.0,413,10,16,0,26,0.34854406879030686
994,mut_micro,8209.0,409,10,16,0,26,0.34493731918997106
995,swap,8209.0,409,10,16,0,26,0.34493731918997106
996,swap,8209.0,409,10,16,0,26,0.34493731918997106
997,swap,8209.0,409,10,16,0,26,0.34493731918997106
998,swap,8209.0,409,10,16,0,26,0.34493731918997106
999,swap,8209.0,409,10,16,0,26,0.34493731918997106
1000,swap,8209.0,409,10,16,0,26,0.34493731918997106
