iter,op,fitness_score,pref_penalty,capacity_viol,elig_viol,under_cap,total_violations,gini
1,swap,29423.0,363,36,60,13,96,0.27928607340372047
2,reassign,29423.0,363,36,60,13,96,0.27928607340372047
3,mut_micro,29419.0,359,36,60,13,96,0.27437172051919373
4,mut_micro,29115.0,355,35,60,13,95,0.27322628215631667
5,mut_micro,28811.0,351,35,59,13,94,0.2681088964511424
6,mut_micro,28811.0,351,35,59,13,94,0.2681088964511424
7,mut_micro,27873.0,353,33,58,11,91,0.2668784965509749
8,mut_micro,27873.0,353,33,58,11,91,0.2668784965509749
9,mut_micro,27571.0,351,31,59,11,90,0.2681088964511424
10,mut_micro,27571.0,351,31,59,11,90,0.2681088964511424
11,swap,27571.0,351,31,59,11,90,0.2681088964511424
12,mut_micro,26968.0,348,30,58,11,88,0.2655630558234223
13,mut_micro,26968.0,348,30,58,11,88,0.2655630558234223
14,mut_micro,26968.0,348,30,58,11,88,0.2655630558234223
15,mut_micro,26968.0,348,30,58,11,88,0.2655630558234223
16,mut_micro,26968.0,348,30,58,11,88,0.2655630558234223
17,mut_micro,26669.0,349,30,57,11,87,0.2663174858984691
18,reassign,26669.0,349,30,57,11,87,0.2663174858984691
19,mut_micro,26669.0,349,30,57,11,87,0.2663174858984691
20,mut_micro,26669.0,349,30,57,11,87,0.2663174858984691
21,mut_micro,26669.0,349,30,57,11,87,0.2663174858984691
22,mut_micro,26669.0,349,30,57,11,87,0.2663174858984691
23,mut_micro,26669.0,349,30,57,11,87,0.2663174858984691
24,swap,26669.0,349,30,57,11,87,0.2663174858984691
25,reassign,26072.0,352,29,56,11,85,0.26882244610551403
26,swap,26072.0,352,29,56,11,85,0.26882244610551403
27,swap,26072.0,352,29,56,11,85,0.26882244610551403
28,swap,26072.0,352,29,56,11,85,0.26882244610551403
29,swap,26072.0,352,29,56,11,85,0.26882244610551403
30,swap,26072.0,352,29,56,11,85,0.26882244610551403
31,swap,26072.0,352,29,56,11,85,0.26882244610551403
32,swap,26072.0,352,29,56,11,85,0.26882244610551403
33,swap,26072.0,352,29,56,11,85,0.26882244610551403
34,swap,26072.0,352,29,56,11,85,0.26882244610551403
35,swap,26072.0,352,29,56,11,85,0.26882244610551403
36,swap,26072.0,352,29,56,11,85,0.26882244610551403
37,swap,26072.0,352,29,56,11,85,0.26882244610551403
38,swap,26072.0,352,29,56,11,85,0.26882244610551403
39,swap,26072.0,352,29,56,11,85,0.26882244610551403
40,swap,25781.0,361,29,55,11,84,0.27770371604732547
41,swap,25486.0,366,29,54,11,83,0.2852152355194951
42,swap,25486.0,366,29,54,11,83,0.2852152355194951
43,swap,25486.0,366,29,54,11,83,0.2852152355194951
44,swap,25486.0,366,29,54,11,83,0.2852152355194951
45,swap,25486.0,366,29,54,11,83,0.2852152355194951
46,swap,25486.0,366,29,54,11,83,0.2852152355194951
47,swap,25189.0,369,29,53,11,82,0.29011082693947127
48,swap,25189.0,369,29,53,11,82,0.29011082693947127
49,swap,24895.0,375,29,52,11,81,0.29964139047949556
50,swap,24596.0,376,29,51,11,80,0.3021812275205941
51,swap,24596.0,376,29,51,11,80,0.3021812275205941
52,swap,24596.0,376,29,51,11,80,0.3021812275205941
53,swap,24596.0,376,29,51,11,80,0.3021812275205941
54,swap,24595.0,375,29,51,11,80,0.3016657990629879
55,swap,24301.0,381,29,50,11,79,0.3102808691043985
56,swap,24300.0,380,29,50,11,79,0.3122578372666432
57,swap,24300.0,380,29,50,11,79,0.3122578372666432
58,swap,24300.0,380,29,50,11,79,0.3122578372666432
59,swap,24300.0,380,29,50,11,79,0.3122578372666432
60,swap,24300.0,380,29,50,11,79,0.3122578372666432
61,swap,24298.0,378,29,50,11,79,0.31004901960784326
62,swap,24298.0,378,29,50,11,79,0.31004901960784326
63,swap,24298.0,378,29,50,11,79,0.31004901960784326
64,swap,23999.0,379,29,49,11,78,0.31240854550775543
65,swap,23999.0,379,29,49,11,78,0.31240854550775543
66,swap,23999.0,379,29,49,11,78,0.31240854550775543
67,swap,23999.0,379,29,49,11,78,0.31240854550775543
68,swap,23999.0,379,29,49,11,78,0.31240854550775543
69,swap,23999.0,379,29,49,11,78,0.31240854550775543
70,mut_micro,23999.0,379,29,49,11,78,0.31240854550775543
71,swap,23999.0,379,29,49,11,78,0.31240854550775543
72,swap,23999.0,379,29,49,11,78,0.31240854550775543
73,swap,23703.0,383,29,48,11,77,0.31689473372430554
74,swap,23108.0,388,29,46,11,75,0.3235294117647059
75,swap,23108.0,388,29,46,11,75,0.3235294117647059
76,swap,23108.0,388,29,46,11,75,0.3235294117647059
77,swap,23108.0,388,29,46,11,75,0.3235294117647059
78,swap,23107.0,387,29,46,11,75,0.3212508244888171
79,swap,23107.0,387,29,46,11,75,0.3212508244888171
80,swap,22812.0,392,29,45,11,74,0.3259651686761661
81,swap,22517.0,397,29,44,11,73,0.3339828044782583
82,swap,22223.0,403,29,43,11,72,0.3380934367316058
83,swap,22223.0,403,29,43,11,72,0.3380934367316058
84,swap,22223.0,403,29,43,11,72,0.3380934367316058
85,swap,22223.0,403,29,43,11,72,0.3380934367316058
86,swap,22223.0,403,29,43,11,72,0.3380934367316058
87,swap,21922.0,402,29,42,11,71,0.3366641528406233
88,swap,21922.0,402,29,42,11,71,0.3366641528406233
89,swap,21922.0,402,29,42,11,71,0.3366641528406233
90,swap,21922.0,402,29,42,11,71,0.3366641528406233
91,swap,21922.0,402,29,42,11,71,0.3366641528406233
92,swap,21922.0,402,29,42,11,71,0.3366641528406233
93,swap,21922.0,402,29,42,11,71,0.3366641528406233
94,swap,21922.0,402,29,42,11,71,0.3366641528406233
95,swap,21628.0,408,29,41,11,70,0.34127899525823413
96,swap,21330.0,410,29,40,11,69,0.3448142414860681
97,swap,21032.0,412,29,39,11,68,0.34826645890144137
98,swap,21032.0,412,29,39,11,68,0.34826645890144137
99,swap,21032.0,412,29,39,11,68,0.34826645890144137
100,mut_micro,21032.0,412,29,39,11,68,0.34826645890144137
101,swap,21032.0,412,29,39,11,68,0.34826645890144137
102,swap,21032.0,412,29,39,11,68,0.34826645890144137
103,swap,21032.0,412,29,39,11,68,0.34826645890144137
104,swap,21032.0,412,29,39,11,68,0.34826645890144137
105,swap,20437.0,417,29,37,11,66,0.3552848748927181
106,swap,20437.0,417,29,37,11,66,0.3552848748927181
107,swap,20437.0,417,29,37,11,66,0.3552848748927181
108,swap,20437.0,417,29,37,11,66,0.3552848748927181
109,swap,20141.0,421,29,36,11,65,0.36073746904905296
110,swap,20141.0,421,29,36,11,65,0.36073746904905296
111,swap,20141.0,421,29,36,11,65,0.36073746904905296
112,swap,19845.0,425,29,35,11,64,0.3638306533686138
113,swap,19845.0,425,29,35,11,64,0.3638306533686138
114,swap,19247.0,427,29,33,11,62,0.36684429869508783
115,swap,19247.0,427,29,33,11,62,0.36684429869508783
116,swap,19247.0,427,29,33,11,62,0.36684429869508783
117,swap,19247.0,427,29,33,11,62,0.36684429869508783
118,swap,19247.0,427,29,33,11,62,0.36684429869508783
119,swap,19247.0,427,29,33,11,62,0.36684429869508783
120,swap,19247.0,427,29,33,11,62,0.36684429869508783
121,swap,19247.0,427,29,33,11,62,0.36684429869508783
122,swap,19247.0,427,29,33,11,62,0.36684429869508783
123,swap,19247.0,427,29,33,11,62,0.36684429869508783
124,swap,19247.0,427,29,33,11,62,0.36684429869508783
125,reassign,19247.0,427,29,33,11,62,0.36684429869508783
126,swap,19247.0,427,29,33,11,62,0.36684429869508783
127,swap,19247.0,427,29,33,11,62,0.36684429869508783
128,swap,19247.0,427,29,33,11,62,0.36684429869508783
129,swap,19247.0,427,29,33,11,62,0.36684429869508783
130,swap,19247.0,427,29,33,11,62,0.36684429869508783
131,swap,19247.0,427,29,33,11,62,0.36684429869508783
132,swap,19247.0,427,29,33,11,62,0.36684429869508783
133,swap,19247.0,427,29,33,11,62,0.36684429869508783
134,swap,19247.0,427,29,33,11,62,0.36684429869508783
135,mut_micro,19247.0,427,29,33,11,62,0.36684429869508783
136,swap,19247.0,427,29,33,11,62,0.36684429869508783
137,swap,19247.0,427,29,33,11,62,0.36684429869508783
138,swap,19247.0,427,29,33,11,62,0.36684429869508783
139,reassign,18946.0,426,29,32,11,61,0.3681236383442266
140,swap,18946.0,426,29,32,11,61,0.3681236383442266
141,swap,18651.0,431,29,31,11,60,0.3696736645188111
142,swap,18651.0,431,29,31,11,60,0.3696736645188111
143,swap,18651.0,431,29,31,11,60,0.3696736645188111
144,swap,18651.0,431,29,31,11,60,0.3696736645188111
145,swap,18651.0,431,29,31,11,60,0.3696736645188111
146,swap,18651.0,431,29,31,11,60,0.3696736645188111
147,swap,18651.0,431,29,31,11,60,0.3696736645188111
148,swap,18651.0,431,29,31,11,60,0.3696736645188111
149,swap,18651.0,431,29,31,11,60,0.3696736645188111
150,reassign,18651.0,431,29,31,11,60,0.3696736645188111
151,reassign,18350.0,430,28,31,11,59,0.3678541839270918
152,reassign,18350.0,430,28,31,11,59,0.3678541839270918
153,reassign,18350.0,430,28,31,11,59,0.3678541839270918
154,reassign,18350.0,430,28,31,11,59,0.3678541839270918
155,reassign,18350.0,430,28,31,11,59,0.3678541839270918
156,swap,18350.0,430,28,31,11,59,0.3678541839270918
157,swap,18350.0,430,28,31,11,59,0.3678541839270918
158,swap,18350.0,430,28,31,11,59,0.3678541839270918
159,swap,18350.0,430,28,31,11,59,0.3678541839270918
160,swap,18350.0,430,28,31,11,59,0.3678541839270918
161,swap,18350.0,430,28,31,11,59,0.3678541839270918
162,swap,18350.0,430,28,31,11,59,0.3678541839270918
163,swap,18350.0,430,28,31,11,59,0.3678541839270918
164,swap,18350.0,430,28,31,11,59,0.3678541839270918
165,reassign,18350.0,430,28,31,11,59,0.3678541839270918
166,mut_micro,17749.0,429,27,30,11,57,0.36673546611627095
167,swap,17749.0,429,27,30,11,57,0.36673546611627095
168,swap,17749.0,429,27,30,11,57,0.36673546611627095
169,mut_micro,17749.0,429,27,30,11,57,0.36673546611627095
170,swap,17749.0,429,27,30,11,57,0.36673546611627095
171,swap,17749.0,429,27,30,11,57,0.36673546611627095
172,swap,17749.0,429,27,30,11,57,0.36673546611627095
173,swap,17749.0,429,27,30,11,57,0.36673546611627095
174,swap,17749.0,429,27,30,11,57,0.36673546611627095
175,swap,17749.0,429,27,30,11,57,0.36673546611627095
176,swap,17749.0,429,27,30,11,57,0.36673546611627095
177,swap,17749.0,429,27,30,11,57,0.36673546611627095
178,reassign,17749.0,429,27,30,11,57,0.36673546611627095
179,swap,17749.0,429,27,30,11,57,0.36673546611627095
180,swap,17749.0,429,27,30,11,57,0.36673546611627095
181,swap,17749.0,429,27,30,11,57,0.36673546611627095
182,swap,17749.0,429,27,30,11,57,0.36673546611627095
183,swap,17749.0,429,27,30,11,57,0.36673546611627095
184,swap,17749.0,429,27,30,11,57,0.36673546611627095
185,swap,17746.0,426,27,30,11,57,0.3634940087145969
186,swap,17746.0,426,27,30,11,57,0.3634940087145969
187,swap,17746.0,426,27,30,11,57,0.3634940087145969
188,swap,17746.0,426,27,30,11,57,0.3634940087145969
189,swap,17746.0,426,27,30,11,57,0.3634940087145969
190,swap,17746.0,426,27,30,11,57,0.3634940087145969
191,mut_micro,17746.0,426,27,30,11,57,0.3634940087145969
192,swap,17746.0,426,27,30,11,57,0.3634940087145969
193,swap,17451.0,431,27,29,11,56,0.3681493798933001
194,swap,17451.0,431,27,29,11,56,0.3681493798933001
195,swap,17451.0,431,27,29,11,56,0.3681493798933001
196,swap,17451.0,431,27,29,11,56,0.3681493798933001
197,swap,17451.0,431,27,29,11,56,0.3681493798933001
198,swap,17451.0,431,27,29,11,56,0.3681493798933001
199,swap,17451.0,431,27,29,11,56,0.3681493798933001
200,swap,17451.0,431,27,29,11,56,0.3681493798933001
201,swap,17451.0,431,27,29,11,56,0.3681493798933001
202,swap,17451.0,431,27,29,11,56,0.3681493798933001
203,swap,17451.0,431,27,29,11,56,0.3681493798933001
204,swap,17451.0,431,27,29,11,56,0.3681493798933001
205,swap,17451.0,431,27,29,11,56,0.3681493798933001
206,swap,17451.0,431,27,29,11,56,0.3681493798933001
207,swap,17451.0,431,27,29,11,56,0.3681493798933001
208,swap,17451.0,431,27,29,11,56,0.3681493798933001
209,swap,17155.0,435,27,28,11,55,0.3729355541499754
210,reassign,16858.0,438,27,27,11,54,0.371199204319409
211,swap,16858.0,438,27,27,11,54,0.371199204319409
212,swap,16858.0,438,27,27,11,54,0.371199204319409
213,swap,16858.0,438,27,27,11,54,0.371199204319409
214,swap,16858.0,438,27,27,11,54,0.371199204319409
215,swap,16858.0,438,27,27,11,54,0.371199204319409
216,swap,16858.0,438,27,27,11,54,0.371199204319409
217,reassign,16858.0,438,27,27,11,54,0.371199204319409
218,swap,16858.0,438,27,27,11,54,0.371199204319409
219,swap,16858.0,438,27,27,11,54,0.371199204319409
220,swap,16858.0,438,27,27,11,54,0.371199204319409
221,swap,16858.0,438,27,27,11,54,0.371199204319409
222,swap,16857.0,437,27,27,11,54,0.3694698095844837
223,swap,16857.0,437,27,27,11,54,0.3694698095844837
224,swap,16857.0,437,27,27,11,54,0.3694698095844837
225,swap,16563.0,443,27,26,11,53,0.3702698791693801
226,swap,16562.0,442,27,26,11,53,0.3703143021914649
227,swap,16562.0,442,27,26,11,53,0.3703143021914649
228,swap,16562.0,442,27,26,11,53,0.3703143021914649
229,swap,16271.0,451,27,25,11,52,0.3726608514128084
230,swap,16271.0,451,27,25,11,52,0.3726608514128084
231,swap,16271.0,451,27,25,11,52,0.3726608514128084
232,swap,16270.0,450,27,25,11,52,0.37277183600713004
233,swap,16270.0,450,27,25,11,52,0.37277183600713004
234,reassign,16270.0,450,27,25,11,52,0.37277183600713004
235,swap,16270.0,450,27,25,11,52,0.37277183600713004
236,reassign,16231.0,451,26,26,9,52,0.37437560575561024
237,swap,16231.0,451,26,26,9,52,0.37437560575561024
238,swap,16231.0,451,26,26,9,52,0.37437560575561024
239,swap,16231.0,451,26,26,9,52,0.37437560575561024
240,swap,16231.0,451,26,26,9,52,0.37437560575561024
241,swap,16231.0,451,26,26,9,52,0.37437560575561024
242,swap,16231.0,451,26,26,9,52,0.37437560575561024
243,swap,16231.0,451,26,26,9,52,0.37437560575561024
244,swap,16231.0,451,26,26,9,52,0.37437560575561024
245,swap,16231.0,451,26,26,9,52,0.37437560575561024
246,swap,16231.0,451,26,26,9,52,0.37437560575561024
247,swap,16231.0,451,26,26,9,52,0.37437560575561024
248,swap,16231.0,451,26,26,9,52,0.37437560575561024
249,mut_micro,16231.0,451,26,26,9,52,0.37437560575561024
250,swap,16231.0,451,26,26,9,52,0.37437560575561024
251,swap,16231.0,451,26,26,9,52,0.37437560575561024
252,swap,16231.0,451,26,26,9,52,0.37437560575561024
253,swap,16231.0,451,26,26,9,52,0.37437560575561024
254,swap,15934.0,454,26,25,9,51,0.3783559577677227
255,swap,15934.0,454,26,25,9,51,0.3783559577677227
256,swap,15934.0,454,26,25,9,51,0.3783559577677227
257,swap,15934.0,454,26,25,9,51,0.3783559577677227
258,swap,15934.0,454,26,25,9,51,0.3783559577677227
259,swap,15934.0,454,26,25,9,51,0.3783559577677227
260,swap,15934.0,454,26,25,9,51,0.3783559577677227
261,swap,15931.0,451,26,25,9,51,0.37594125102512493
262,swap,15931.0,451,26,25,9,51,0.37594125102512493
263,swap,15931.0,451,26,25,9,51,0.37594125102512493
264,swap,15931.0,451,26,25,9,51,0.37594125102512493
265,swap,15931.0,451,26,25,9,51,0.37594125102512493
266,mut_micro,15633.0,453,25,25,9,50,0.37348809255502957
267,swap,15633.0,453,25,25,9,50,0.37348809255502957
268,swap,15633.0,453,25,25,9,50,0.37348809255502957
269,reassign,15335.0,455,25,24,9,49,0.3725868725868726
270,swap,15335.0,455,25,24,9,49,0.3725868725868726
271,mut_micro,15335.0,455,25,24,9,49,0.3725868725868726
272,swap,15335.0,455,25,24,9,49,0.3725868725868726
273,mut_micro,15335.0,455,25,24,9,49,0.3725868725868726
274,swap,15335.0,455,25,24,9,49,0.3725868725868726
275,swap,15335.0,455,25,24,9,49,0.3725868725868726
276,swap,15335.0,455,25,24,9,49,0.3725868725868726
277,reassign,15335.0,455,25,24,9,49,0.3725868725868726
278,swap,15335.0,455,25,24,9,49,0.3725868725868726
279,swap,15037.0,457,25,23,9,48,0.3750286106660563
280,swap,15037.0,457,25,23,9,48,0.3750286106660563
281,reassign,15037.0,457,25,23,9,48,0.3750286106660563
282,swap,15035.0,455,25,23,9,48,0.37410099174805067
283,mut_micro,15035.0,455,25,23,9,48,0.37410099174805067
284,swap,15035.0,455,25,23,9,48,0.37410099174805067
285,swap,15035.0,455,25,23,9,48,0.37410099174805067
286,swap,15035.0,455,25,23,9,48,0.37410099174805067
287,mut_micro,14435.0,455,23,23,9,46,0.37410099174805067
288,swap,14435.0,455,23,23,9,46,0.37410099174805067
289,swap,14435.0,455,23,23,9,46,0.37410099174805067
290,swap,14435.0,455,23,23,9,46,0.37410099174805067
291,swap,14435.0,455,23,23,9,46,0.37410099174805067
292,mut_micro,14435.0,455,23,23,9,46,0.37410099174805067
293,swap,14435.0,455,23,23,9,46,0.37410099174805067
294,swap,14435.0,455,23,23,9,46,0.37410099174805067
295,swap,14435.0,455,23,23,9,46,0.37410099174805067
296,swap,14435.0,455,23,23,9,46,0.37410099174805067
297,reassign,14435.0,455,23,23,9,46,0.37410099174805067
298,swap,14435.0,455,23,23,9,46,0.37410099174805067
299,swap,14435.0,455,23,23,9,46,0.37410099174805067
300,swap,14435.0,455,23,23,9,46,0.37410099174805067
301,swap,14141.0,461,23,22,9,45,0.3750678136867396
302,swap,14141.0,461,23,22,9,45,0.3750678136867396
303,swap,14141.0,461,23,22,9,45,0.3750678136867396
304,swap,14141.0,461,23,22,9,45,0.3750678136867396
305,swap,14141.0,461,23,22,9,45,0.3750678136867396
306,swap,13848.0,468,23,21,9,44,0.3780487804878049
307,swap,13551.0,471,23,20,9,43,0.37743080771403203
308,swap,13551.0,471,23,20,9,43,0.37743080771403203
309,swap,13551.0,471,23,20,9,43,0.37743080771403203
310,swap,13551.0,471,23,20,9,43,0.37743080771403203
311,swap,13551.0,471,23,20,9,43,0.37743080771403203
312,swap,13551.0,471,23,20,9,43,0.37743080771403203
313,swap,13551.0,471,23,20,9,43,0.37743080771403203
314,swap,13551.0,471,23,20,9,43,0.37743080771403203
315,swap,13551.0,471,23,20,9,43,0.37743080771403203
316,swap,13551.0,471,23,20,9,43,0.37743080771403203
317,swap,13551.0,471,23,20,9,43,0.37743080771403203
318,swap,13551.0,471,23,20,9,43,0.37743080771403203
319,swap,13551.0,471,23,20,9,43,0.37743080771403203
320,swap,13551.0,471,23,20,9,43,0.37743080771403203
321,swap,13551.0,471,23,20,9,43,0.37743080771403203
322,swap,13551.0,471,23,20,9,43,0.37743080771403203
323,swap,13551.0,471,23,20,9,43,0.37743080771403203
324,swap,13551.0,471,23,20,9,43,0.37743080771403203
325,swap,13551.0,471,23,20,9,43,0.37743080771403203
326,swap,13551.0,471,23,20,9,43,0.37743080771403203
327,swap,13551.0,471,23,20,9,43,0.37743080771403203
328,swap,13551.0,471,23,20,9,43,0.37743080771403203
329,swap,13551.0,471,23,20,9,43,0.37743080771403203
330,swap,13551.0,471,23,20,9,43,0.37743080771403203
331,swap,13254.0,474,23,19,9,42,0.3790032679738562
332,swap,13254.0,474,23,19,9,42,0.3790032679738562
333,swap,13254.0,474,23,19,9,42,0.3790032679738562
334,swap,13254.0,474,23,19,9,42,0.3790032679738562
335,swap,13254.0,474,23,19,9,42,0.3790032679738562
336,swap,13254.0,474,23,19,9,42,0.3790032679738562
337,swap,13254.0,474,23,19,9,42,0.3790032679738562
338,swap,13251.0,471,23,19,9,42,0.38235294117647056
339,swap,13251.0,471,23,19,9,42,0.38235294117647056
340,swap,13251.0,471,23,19,9,42,0.38235294117647056
341,swap,13251.0,471,23,19,9,42,0.38235294117647056
342,reassign,12911.0,471,22,19,7,41,0.38235294117647056
343,swap,12911.0,471,22,19,7,41,0.38235294117647056
344,swap,12911.0,471,22,19,7,41,0.38235294117647056
345,swap,12911.0,471,22,19,7,41,0.38235294117647056
346,swap,12911.0,471,22,19,7,41,0.38235294117647056
347,swap,12911.0,471,22,19,7,41,0.38235294117647056
348,swap,12911.0,471,22,19,7,41,0.38235294117647056
349,swap,12911.0,471,22,19,7,41,0.38235294117647056
350,reassign,12911.0,471,22,19,7,41,0.38235294117647056
351,swap,12911.0,471,22,19,7,41,0.38235294117647056
352,swap,12911.0,471,22,19,7,41,0.38235294117647056
353,swap,12911.0,471,22,19,7,41,0.38235294117647056
354,swap,12911.0,471,22,19,7,41,0.38235294117647056
355,swap,12911.0,471,22,19,7,41,0.38235294117647056
356,swap,12911.0,471,22,19,7,41,0.38235294117647056
357,swap,12616.0,476,22,18,7,40,0.38078760916131155
358,swap,12616.0,476,22,18,7,40,0.38078760916131155
359,swap,12616.0,476,22,18,7,40,0.38078760916131155
360,swap,12616.0,476,22,18,7,40,0.38078760916131155
361,swap,12616.0,476,22,18,7,40,0.38078760916131155
362,swap,12616.0,476,22,18,7,40,0.38078760916131155
363,swap,12616.0,476,22,18,7,40,0.38078760916131155
364,swap,12616.0,476,22,18,7,40,0.38078760916131155
365,swap,12616.0,476,22,18,7,40,0.38078760916131155
366,swap,12616.0,476,22,18,7,40,0.38078760916131155
367,swap,12616.0,476,22,18,7,40,0.38078760916131155
368,swap,12616.0,476,22,18,7,40,0.38078760916131155
369,swap,12616.0,476,22,18,7,40,0.38078760916131155
370,swap,12616.0,476,22,18,7,40,0.38078760916131155
371,swap,12616.0,476,22,18,7,40,0.38078760916131155
372,reassign,12616.0,476,22,18,7,40,0.38078760916131155
373,swap,12616.0,476,22,18,7,40,0.38078760916131155
374,swap,12616.0,476,22,18,7,40,0.38078760916131155
375,swap,12616.0,476,22,18,7,40,0.38078760916131155
376,swap,12616.0,476,22,18,7,40,0.38078760916131155
377,swap,12616.0,476,22,18,7,40,0.38078760916131155
378,reassign,12616.0,476,22,18,7,40,0.38078760916131155
379,swap,12614.0,474,22,18,7,40,0.3838235294117648
380,swap,12614.0,474,22,18,7,40,0.3838235294117648
381,mut_micro,12614.0,474,22,18,7,40,0.3838235294117648
382,swap,12614.0,474,22,18,7,40,0.3838235294117648
383,swap,12614.0,474,22,18,7,40,0.3838235294117648
384,swap,12614.0,474,22,18,7,40,0.3838235294117648
385,swap,12609.0,469,22,18,7,40,0.3851540616246498
386,swap,12609.0,469,22,18,7,40,0.3851540616246498
387,swap,12609.0,469,22,18,7,40,0.3851540616246498
388,swap,12609.0,469,22,18,7,40,0.3851540616246498
389,swap,12609.0,469,22,18,7,40,0.3851540616246498
390,swap,12609.0,469,22,18,7,40,0.3851540616246498
391,swap,12609.0,469,22,18,7,40,0.3851540616246498
392,swap,12609.0,469,22,18,7,40,0.3851540616246498
393,swap,12609.0,469,22,18,7,40,0.3851540616246498
394,swap,12609.0,469,22,18,7,40,0.3851540616246498
395,swap,12609.0,469,22,18,7,40,0.3851540616246498
396,swap,12609.0,469,22,18,7,40,0.3851540616246498
397,swap,12609.0,469,22,18,7,40,0.3851540616246498
398,swap,12609.0,469,22,18,7,40,0.3851540616246498
399,mut_micro,12310.0,470,22,17,7,39,0.3841208614593378
400,mut_micro,12310.0,470,22,17,7,39,0.3841208614593378
401,mut_micro,12310.0,470,22,17,7,39,0.3841208614593378
402,swap,12310.0,470,22,17,7,39,0.3841208614593378
403,swap,12310.0,470,22,17,7,39,0.3841208614593378
404,swap,12310.0,470,22,17,7,39,0.3841208614593378
405,swap,12308.0,468,22,17,7,39,0.38538179499442055
406,swap,12308.0,468,22,17,7,39,0.38538179499442055
407,swap,12015.0,475,22,16,7,38,0.3872754122569529
408,swap,12015.0,475,22,16,7,38,0.3872754122569529
409,swap,12015.0,475,22,16,7,38,0.3872754122569529
410,swap,12015.0,475,22,16,7,38,0.3872754122569529
411,swap,12015.0,475,22,16,7,38,0.3872754122569529
412,swap,12015.0,475,22,16,7,38,0.3872754122569529
413,swap,12015.0,475,22,16,7,38,0.3872754122569529
414,swap,12015.0,475,22,16,7,38,0.3872754122569529
415,swap,12015.0,475,22,16,7,38,0.3872754122569529
416,swap,12015.0,475,22,16,7,38,0.3872754122569529
417,swap,12015.0,475,22,16,7,38,0.3872754122569529
418,swap,12015.0,475,22,16,7,38,0.3872754122569529
419,swap,12015.0,475,22,16,7,38,0.3872754122569529
420,swap,12015.0,475,22,16,7,38,0.3872754122569529
421,swap,12015.0,475,22,16,7,38,0.3872754122569529
422,swap,12015.0,475,22,16,7,38,0.3872754122569529
423,swap,12015.0,475,22,16,7,38,0.3872754122569529
424,swap,12015.0,475,22,16,7,38,0.3872754122569529
425,swap,12015.0,475,22,16,7,38,0.3872754122569529
426,swap,12015.0,475,22,16,7,38,0.3872754122569529
427,swap,12015.0,475,22,16,7,38,0.3872754122569529
428,swap,12015.0,475,22,16,7,38,0.3872754122569529
429,swap,12015.0,475,22,16,7,38,0.3872754122569529
430,swap,12015.0,475,22,16,7,38,0.3872754122569529
431,swap,12015.0,475,22,16,7,38,0.3872754122569529
432,swap,12015.0,475,22,16,7,38,0.3872754122569529
433,swap,11720.0,480,22,15,7,37,0.3854533266297972
434,swap,11720.0,480,22,15,7,37,0.3854533266297972
435,swap,11720.0,480,22,15,7,37,0.3854533266297972
436,swap,11720.0,480,22,15,7,37,0.3854533266297972
437,swap,11720.0,480,22,15,7,37,0.3854533266297972
438,swap,11720.0,480,22,15,7,37,0.3854533266297972
439,reassign,11720.0,480,22,15,7,37,0.3854533266297972
440,swap,11720.0,480,22,15,7,37,0.3854533266297972
441,swap,11424.0,484,22,14,7,36,0.3872122762148338
442,swap,11424.0,484,22,14,7,36,0.3872122762148338
443,swap,11424.0,484,22,14,7,36,0.3872122762148338
444,swap,11424.0,484,22,14,7,36,0.3872122762148338
445,swap,11424.0,484,22,14,7,36,0.3872122762148338
446,swap,11424.0,484,22,14,7,36,0.3872122762148338
447,swap,11424.0,484,22,14,7,36,0.3872122762148338
448,swap,11424.0,484,22,14,7,36,0.3872122762148338
449,swap,11424.0,484,22,14,7,36,0.3872122762148338
450,swap,11424.0,484,22,14,7,36,0.3872122762148338
451,reassign,11423.0,483,22,14,7,36,0.3883795942619473
452,swap,11423.0,483,22,14,7,36,0.3883795942619473
453,swap,11423.0,483,22,14,7,36,0.3883795942619473
454,swap,11423.0,483,22,14,7,36,0.3883795942619473
455,swap,11423.0,483,22,14,7,36,0.3883795942619473
456,swap,11423.0,483,22,14,7,36,0.3883795942619473
457,swap,11421.0,481,22,14,7,36,0.39127324749642345
458,swap,11421.0,481,22,14,7,36,0.39127324749642345
459,swap,11421.0,481,22,14,7,36,0.39127324749642345
460,swap,11421.0,481,22,14,7,36,0.39127324749642345
461,swap,11421.0,481,22,14,7,36,0.39127324749642345
462,swap,11420.0,480,22,14,7,36,0.3903971845148315
463,swap,11420.0,480,22,14,7,36,0.3903971845148315
464,swap,11420.0,480,22,14,7,36,0.3903971845148315
465,swap,11420.0,480,22,14,7,36,0.3903971845148315
466,swap,11420.0,480,22,14,7,36,0.3903971845148315
467,swap,11420.0,480,22,14,7,36,0.3903971845148315
468,swap,11420.0,480,22,14,7,36,0.3903971845148315
469,swap,11420.0,480,22,14,7,36,0.3903971845148315
470,swap,11420.0,480,22,14,7,36,0.3903971845148315
471,swap,11420.0,480,22,14,7,36,0.3903971845148315
472,swap,11420.0,480,22,14,7,36,0.3903971845148315
473,swap,11420.0,480,22,14,7,36,0.3903971845148315
474,swap,11420.0,480,22,14,7,36,0.3903971845148315
475,swap,11420.0,480,22,14,7,36,0.3903971845148315
476,swap,11420.0,480,22,14,7,36,0.3903971845148315
477,swap,11420.0,480,22,14,7,36,0.3903971845148315
478,swap,11420.0,480,22,14,7,36,0.3903971845148315
479,swap,11420.0,480,22,14,7,36,0.3903971845148315
480,swap,11420.0,480,22,14,7,36,0.3903971845148315
481,swap,11420.0,480,22,14,7,36,0.3903971845148315
482,swap,11420.0,480,22,14,7,36,0.3903971845148315
483,swap,11420.0,480,22,14,7,36,0.3903971845148315
484,swap,11420.0,480,22,14,7,36,0.3903971845148315
485,swap,11420.0,480,22,14,7,36,0.3903971845148315
486,swap,11420.0,480,22,14,7,36,0.3903971845148315
487,swap,11420.0,480,22,14,7,36,0.3903971845148315
488,swap,11420.0,480,22,14,7,36,0.3903971845148315
489,swap,11420.0,480,22,14,7,36,0.3903971845148315
490,swap,11420.0,480,22,14,7,36,0.3903971845148315
491,swap,11420.0,480,22,14,7,36,0.3903971845148315
492,swap,11420.0,480,22,14,7,36,0.3903971845148315
493,mut_micro,11420.0,480,22,14,7,36,0.3903971845148315
494,mut_micro,11416.0,476,22,14,7,36,0.39042675893886963
495,mut_micro,11416.0,476,22,14,7,36,0.39042675893886963
496,mut_micro,11416.0,476,22,14,7,36,0.39042675893886963
497,swap,11416.0,476,22,14,7,36,0.39042675893886963
498,swap,11416.0,476,22,14,7,36,0.39042675893886963
499,swap,11416.0,476,22,14,7,36,0.39042675893886963
500,swap,11416.0,476,22,14,7,36,0.39042675893886963
501,swap,11416.0,476,22,14,7,36,0.39042675893886963
502,mut_micro,11416.0,476,22,14,7,36,0.39042675893886963
503,mut_micro,11416.0,476,22,14,7,36,0.39042675893886963
504,reassign,11416.0,476,22,14,7,36,0.39042675893886963
505,mut_micro,11414.0,474,22,14,7,36,0.3916666666666667
506,mut_micro,11414.0,474,22,14,7,36,0.3916666666666667
507,mut_micro,11414.0,474,22,14,7,36,0.3916666666666667
508,swap,11414.0,474,22,14,7,36,0.3916666666666667
509,mut_micro,11414.0,474,22,14,7,36,0.3916666666666667
510,mut_micro,11393.0,473,22,14,6,36,0.3906516963631925
511,mut_micro,11393.0,473,22,14,6,36,0.3906516963631925
512,mut_micro,11393.0,473,22,14,6,36,0.3906516963631925
513,mut_micro,11393.0,473,22,14,6,36,0.3906516963631925
514,swap,11393.0,473,22,14,6,36,0.3906516963631925
515,swap,11393.0,473,22,14,6,36,0.3906516963631925
516,reassign,11393.0,473,22,14,6,36,0.3906516963631925
517,swap,11393.0,473,22,14,6,36,0.3906516963631925
518,swap,11393.0,473,22,14,6,36,0.3906516963631925
519,swap,11393.0,473,22,14,6,36,0.3906516963631925
520,swap,11393.0,473,22,14,6,36,0.3906516963631925
521,swap,11393.0,473,22,14,6,36,0.3906516963631925
522,swap,11393.0,473,22,14,6,36,0.3906516963631925
523,swap,11393.0,473,22,14,6,36,0.3906516963631925
524,swap,11393.0,473,22,14,6,36,0.3906516963631925
525,swap,11393.0,473,22,14,6,36,0.3906516963631925
526,swap,11393.0,473,22,14,6,36,0.3906516963631925
527,swap,11393.0,473,22,14,6,36,0.3906516963631925
528,swap,11393.0,473,22,14,6,36,0.3906516963631925
529,swap,11393.0,473,22,14,6,36,0.3906516963631925
530,swap,11393.0,473,22,14,6,36,0.3906516963631925
531,swap,11393.0,473,22,14,6,36,0.3906516963631925
532,swap,11393.0,473,22,14,6,36,0.3906516963631925
533,swap,11393.0,473,22,14,6,36,0.3906516963631925
534,swap,11393.0,473,22,14,6,36,0.3906516963631925
535,mut_micro,11393.0,473,22,14,6,36,0.3906516963631925
536,swap,11393.0,473,22,14,6,36,0.3906516963631925
537,swap,11393.0,473,22,14,6,36,0.3906516963631925
538,swap,11393.0,473,22,14,6,36,0.3906516963631925
539,swap,11393.0,473,22,14,6,36,0.3906516963631925
540,swap,11393.0,473,22,14,6,36,0.3906516963631925
541,swap,11393.0,473,22,14,6,36,0.3906516963631925
542,swap,11393.0,473,22,14,6,36,0.3906516963631925
543,swap,11393.0,473,22,14,6,36,0.3906516963631925
544,swap,11393.0,473,22,14,6,36,0.3906516963631925
545,swap,11393.0,473,22,14,6,36,0.3906516963631925
546,swap,11393.0,473,22,14,6,36,0.3906516963631925
547,swap,11393.0,473,22,14,6,36,0.3906516963631925
548,mut_micro,11393.0,473,22,14,6,36,0.3906516963631925
549,reassign,11393.0,473,22,14,6,36,0.3906516963631925
550,swap,11393.0,473,22,14,6,36,0.3906516963631925
551,swap,11393.0,473,22,14,6,36,0.3906516963631925
552,swap,11393.0,473,22,14,6,36,0.3906516963631925
553,swap,11393.0,473,22,14,6,36,0.3906516963631925
554,swap,11393.0,473,22,14,6,36,0.3906516963631925
555,swap,11393.0,473,22,14,6,36,0.3906516963631925
556,swap,11393.0,473,22,14,6,36,0.3906516963631925
557,swap,11393.0,473,22,14,6,36,0.3906516963631925
558,swap,11393.0,473,22,14,6,36,0.3906516963631925
559,swap,11393.0,473,22,14,6,36,0.3906516963631925
560,swap,11393.0,473,22,14,6,36,0.3906516963631925
561,swap,11393.0,473,22,14,6,36,0.3906516963631925
562,swap,11393.0,473,22,14,6,36,0.3906516963631925
563,swap,11393.0,473,22,14,6,36,0.3906516963631925
564,swap,11393.0,473,22,14,6,36,0.3906516963631925
565,mut_micro,11393.0,473,22,14,6,36,0.3906516963631925
566,swap,11393.0,473,22,14,6,36,0.3906516963631925
567,mut_micro,11393.0,473,22,14,6,36,0.3906516963631925
568,swap,11393.0,473,22,14,6,36,0.3906516963631925
569,swap,11393.0,473,22,14,6,36,0.3906516963631925
570,swap,11393.0,473,22,14,6,36,0.3906516963631925
571,swap,11393.0,473,22,14,6,36,0.3906516963631925
572,swap,11393.0,473,22,14,6,36,0.3906516963631925
573,swap,11393.0,473,22,14,6,36,0.3906516963631925
574,swap,11393.0,473,22,14,6,36,0.3906516963631925
575,swap,11392.0,472,22,14,6,36,0.38956409009884946
576,swap,11392.0,472,22,14,6,36,0.38956409009884946
577,swap,11096.0,476,22,13,6,35,0.3898500576701268
578,swap,11096.0,476,22,13,6,35,0.3898500576701268
579,swap,11096.0,476,22,13,6,35,0.3898500576701268
580,swap,11096.0,476,22,13,6,35,0.3898500576701268
581,swap,11096.0,476,22,13,6,35,0.3898500576701268
582,swap,11096.0,476,22,13,6,35,0.3898500576701268
583,swap,11096.0,476,22,13,6,35,0.3898500576701268
584,swap,11096.0,476,22,13,6,35,0.3898500576701268
585,swap,11096.0,476,22,13,6,35,0.3898500576701268
586,swap,11091.0,471,22,13,6,35,0.3912289195513596
587,swap,11090.0,470,22,13,6,35,0.3900675024108004
588,swap,11090.0,470,22,13,6,35,0.3900675024108004
589,swap,11090.0,470,22,13,6,35,0.3900675024108004
590,swap,11090.0,470,22,13,6,35,0.3900675024108004
591,swap,11090.0,470,22,13,6,35,0.3900675024108004
592,swap,11090.0,470,22,13,6,35,0.3900675024108004
593,swap,11088.0,468,22,13,6,35,0.3883309421329507
594,swap,11088.0,468,22,13,6,35,0.3883309421329507
595,mut_micro,11088.0,468,22,13,6,35,0.3883309421329507
596,swap,11088.0,468,22,13,6,35,0.3883309421329507
597,swap,11088.0,468,22,13,6,35,0.3883309421329507
598,swap,11088.0,468,22,13,6,35,0.3883309421329507
599,swap,11088.0,468,22,13,6,35,0.3883309421329507
600,swap,11088.0,468,22,13,6,35,0.3883309421329507
601,swap,11082.0,462,22,13,6,35,0.39324618736383443
602,swap,11082.0,462,22,13,6,35,0.39324618736383443
603,swap,11082.0,462,22,13,6,35,0.39324618736383443
604,swap,11082.0,462,22,13,6,35,0.39324618736383443
605,reassign,10782.0,462,21,13,6,34,0.39324618736383443
606,swap,10782.0,462,21,13,6,34,0.39324618736383443
607,swap,10782.0,462,21,13,6,34,0.39324618736383443
608,swap,10782.0,462,21,13,6,34,0.39324618736383443
609,swap,10782.0,462,21,13,6,34,0.39324618736383443
610,swap,10782.0,462,21,13,6,34,0.39324618736383443
611,swap,10782.0,462,21,13,6,34,0.39324618736383443
612,swap,10782.0,462,21,13,6,34,0.39324618736383443
613,swap,10782.0,462,21,13,6,34,0.39324618736383443
614,swap,10782.0,462,21,13,6,34,0.39324618736383443
615,swap,10782.0,462,21,13,6,34,0.39324618736383443
616,swap,10782.0,462,21,13,6,34,0.39324618736383443
617,swap,10782.0,462,21,13,6,34,0.39324618736383443
618,swap,10782.0,462,21,13,6,34,0.39324618736383443
619,reassign,10782.0,462,21,13,6,34,0.39324618736383443
620,swap,10782.0,462,21,13,6,34,0.39324618736383443
621,swap,10777.0,457,21,13,6,34,0.39341573205157543
622,swap,10777.0,457,21,13,6,34,0.39341573205157543
623,mut_micro,10777.0,457,21,13,6,34,0.39341573205157543
624,swap,10777.0,457,21,13,6,34,0.39341573205157543
625,swap,10777.0,457,21,13,6,34,0.39341573205157543
626,swap,10777.0,457,21,13,6,34,0.39341573205157543
627,swap,10777.0,457,21,13,6,34,0.39341573205157543
628,swap,10777.0,457,21,13,6,34,0.39341573205157543
629,swap,10777.0,457,21,13,6,34,0.39341573205157543
630,swap,10482.0,462,21,12,6,33,0.39324618736383443
631,swap,10482.0,462,21,12,6,33,0.39324618736383443
632,swap,10482.0,462,21,12,6,33,0.39324618736383443
633,swap,10482.0,462,21,12,6,33,0.39324618736383443
634,swap,10482.0,462,21,12,6,33,0.39324618736383443
635,swap,10482.0,462,21,12,6,33,0.39324618736383443
636,swap,10482.0,462,21,12,6,33,0.39324618736383443
637,swap,10482.0,462,21,12,6,33,0.39324618736383443
638,swap,10481.0,461,21,12,6,33,0.3919631093544137
639,swap,10481.0,461,21,12,6,33,0.3919631093544137
640,mut_micro,10481.0,461,21,12,6,33,0.3919631093544137
641,swap,10481.0,461,21,12,6,33,0.3919631093544137
642,swap,10481.0,461,21,12,6,33,0.3919631093544137
643,swap,10481.0,461,21,12,6,33,0.3919631093544137
644,swap,10481.0,461,21,12,6,33,0.3919631093544137
645,swap,10481.0,461,21,12,6,33,0.3919631093544137
646,mut_micro,10481.0,461,21,12,6,33,0.3919631093544137
647,swap,10481.0,461,21,12,6,33,0.3919631093544137
648,swap,10481.0,461,21,12,6,33,0.3919631093544137
649,swap,10190.0,470,21,11,6,32,0.39207650273224043
650,swap,10190.0,470,21,11,6,32,0.39207650273224043
651,swap,10190.0,470,21,11,6,32,0.39207650273224043
652,swap,10190.0,470,21,11,6,32,0.39207650273224043
653,swap,10190.0,470,21,11,6,32,0.39207650273224043
654,swap,10190.0,470,21,11,6,32,0.39207650273224043
655,swap,10190.0,470,21,11,6,32,0.39207650273224043
656,swap,10190.0,470,21,11,6,32,0.39207650273224043
657,swap,10190.0,470,21,11,6,32,0.39207650273224043
658,swap,10190.0,470,21,11,6,32,0.39207650273224043
659,swap,10190.0,470,21,11,6,32,0.39207650273224043
660,swap,10190.0,470,21,11,6,32,0.39207650273224043
661,swap,10190.0,470,21,11,6,32,0.39207650273224043
662,swap,10190.0,470,21,11,6,32,0.39207650273224043
663,swap,10190.0,470,21,11,6,32,0.39207650273224043
664,swap,10190.0,470,21,11,6,32,0.39207650273224043
665,swap,10190.0,470,21,11,6,32,0.39207650273224043
666,swap,10190.0,470,21,11,6,32,0.39207650273224043
667,swap,10190.0,470,21,11,6,32,0.39207650273224043
668,swap,10190.0,470,21,11,6,32,0.39207650273224043
669,swap,10190.0,470,21,11,6,32,0.39207650273224043
670,swap,10190.0,470,21,11,6,32,0.39207650273224043
671,swap,10190.0,470,21,11,6,32,0.39207650273224043
672,swap,10190.0,470,21,11,6,32,0.39207650273224043
673,swap,10190.0,470,21,11,6,32,0.39207650273224043
674,swap,10190.0,470,21,11,6,32,0.39207650273224043
675,swap,10190.0,470,21,11,6,32,0.39207650273224043
676,swap,10190.0,470,21,11,6,32,0.39207650273224043
677,swap,10188.0,468,21,11,6,32,0.3904033157978639
678,swap,10188.0,468,21,11,6,32,0.3904033157978639
679,swap,10188.0,468,21,11,6,32,0.3904033157978639
680,swap,10188.0,468,21,11,6,32,0.3904033157978639
681,swap,10188.0,468,21,11,6,32,0.3904033157978639
682,swap,10188.0,468,21,11,6,32,0.3904033157978639
683,swap,10188.0,468,21,11,6,32,0.3904033157978639
684,swap,10188.0,468,21,11,6,32,0.3904033157978639
685,swap,10188.0,468,21,11,6,32,0.3904033157978639
686,swap,10188.0,468,21,11,6,32,0.3904033157978639
687,swap,10188.0,468,21,11,6,32,0.3904033157978639
688,swap,10188.0,468,21,11,6,32,0.3904033157978639
689,swap,10188.0,468,21,11,6,32,0.3904033157978639
690,mut_micro,10188.0,468,21,11,6,32,0.3904033157978639
691,swap,10188.0,468,21,11,6,32,0.3904033157978639
692,swap,10188.0,468,21,11,6,32,0.3904033157978639
693,swap,10188.0,468,21,11,6,32,0.3904033157978639
694,swap,10188.0,468,21,11,6,32,0.3904033157978639
695,swap,10188.0,468,21,11,6,32,0.3904033157978639
696,swap,10188.0,468,21,11,6,32,0.3904033157978639
697,swap,10188.0,468,21,11,6,32,0.3904033157978639
698,swap,10188.0,468,21,11,6,32,0.3904033157978639
699,mut_micro,10188.0,468,21,11,6,32,0.3904033157978639
700,swap,10188.0,468,21,11,6,32,0.3904033157978639
701,swap,10188.0,468,21,11,6,32,0.3904033157978639
702,swap,10188.0,468,21,11,6,32,0.3904033157978639
703,swap,10188.0,468,21,11,6,32,0.3904033157978639
704,swap,10188.0,468,21,11,6,32,0.3904033157978639
705,swap,10188.0,468,21,11,6,32,0.3904033157978639
706,swap,10188.0,468,21,11,6,32,0.3904033157978639
707,swap,10188.0,468,21,11,6,32,0.3904033157978639
708,swap,10188.0,468,21,11,6,32,0.3904033157978639
709,swap,10188.0,468,21,11,6,32,0.3904033157978639
710,swap,10188.0,468,21,11,6,32,0.3904033157978639
711,reassign,10188.0,468,21,11,6,32,0.3904033157978639
712,swap,10188.0,468,21,11,6,32,0.3904033157978639
713,swap,10188.0,468,21,11,6,32,0.3904033157978639
714,swap,10188.0,468,21,11,6,32,0.3904033157978639
715,swap,10188.0,468,21,11,6,32,0.3904033157978639
716,swap,10188.0,468,21,11,6,32,0.3904033157978639
717,swap,10188.0,468,21,11,6,32,0.3904033157978639
718,swap,10188.0,468,21,11,6,32,0.3904033157978639
719,swap,10188.0,468,21,11,6,32,0.3904033157978639
720,swap,10188.0,468,21,11,6,32,0.3904033157978639
721,swap,10188.0,468,21,11,6,32,0.3904033157978639
722,swap,10188.0,468,21,11,6,32,0.3904033157978639
723,swap,10188.0,468,21,11,6,32,0.3904033157978639
724,swap,10188.0,468,21,11,6,32,0.3904033157978639
725,swap,10188.0,468,21,11,6,32,0.3904033157978639
726,swap,10188.0,468,21,11,6,32,0.3904033157978639
727,swap,10187.0,467,21,11,6,32,0.38910057950305615
728,swap,10187.0,467,21,11,6,32,0.38910057950305615
729,swap,10187.0,467,21,11,6,32,0.38910057950305615
730,swap,10187.0,467,21,11,6,32,0.38910057950305615
731,swap,10187.0,467,21,11,6,32,0.38910057950305615
732,swap,10187.0,467,21,11,6,32,0.38910057950305615
733,swap,10187.0,467,21,11,6,32,0.38910057950305615
734,swap,10187.0,467,21,11,6,32,0.38910057950305615
735,swap,10187.0,467,21,11,6,32,0.38910057950305615
736,swap,10187.0,467,21,11,6,32,0.38910057950305615
737,swap,10187.0,467,21,11,6,32,0.38910057950305615
738,swap,10187.0,467,21,11,6,32,0.38910057950305615
739,swap,10187.0,467,21,11,6,32,0.38910057950305615
740,reassign,10187.0,467,21,11,6,32,0.38910057950305615
741,swap,10187.0,467,21,11,6,32,0.38910057950305615
742,swap,10187.0,467,21,11,6,32,0.38910057950305615
743,swap,10187.0,467,21,11,6,32,0.38910057950305615
744,swap,10187.0,467,21,11,6,32,0.38910057950305615
745,swap,10187.0,467,21,11,6,32,0.38910057950305615
746,swap,10187.0,467,21,11,6,32,0.38910057950305615
747,swap,10187.0,467,21,11,6,32,0.38910057950305615
748,swap,10187.0,467,21,11,6,32,0.38910057950305615
749,swap,10187.0,467,21,11,6,32,0.38910057950305615
750,swap,10187.0,467,21,11,6,32,0.38910057950305615
751,swap,10187.0,467,21,11,6,32,0.38910057950305615
752,swap,10187.0,467,21,11,6,32,0.38910057950305615
753,mut_micro,10187.0,467,21,11,6,32,0.38910057950305615
754,swap,10187.0,467,21,11,6,32,0.38910057950305615
755,swap,10187.0,467,21,11,6,32,0.38910057950305615
756,swap,10187.0,467,21,11,6,32,0.38910057950305615
757,swap,10187.0,467,21,11,6,32,0.38910057950305615
758,swap,10187.0,467,21,11,6,32,0.38910057950305615
759,swap,10187.0,467,21,11,6,32,0.38910057950305615
760,swap,10187.0,467,21,11,6,32,0.38910057950305615
761,swap,10187.0,467,21,11,6,32,0.38910057950305615
762,swap,10187.0,467,21,11,6,32,0.38910057950305615
763,swap,10187.0,467,21,11,6,32,0.38910057950305615
764,swap,10187.0,467,21,11,6,32,0.38910057950305615
765,swap,10187.0,467,21,11,6,32,0.38910057950305615
766,swap,10187.0,467,21,11,6,32,0.38910057950305615
767,swap,10187.0,467,21,11,6,32,0.38910057950305615
768,swap,10187.0,467,21,11,6,32,0.38910057950305615
769,swap,10187.0,467,21,11,6,32,0.38910057950305615
770,swap,10187.0,467,21,11,6,32,0.38910057950305615
771,swap,10187.0,467,21,11,6,32,0.38910057950305615
772,swap,10187.0,467,21,11,6,32,0.38910057950305615
773,swap,10187.0,467,21,11,6,32,0.38910057950305615
774,swap,10187.0,467,21,11,6,32,0.38910057950305615
775,swap,10187.0,467,21,11,6,32,0.38910057950305615
776,swap,10187.0,467,21,11,6,32,0.38910057950305615
777,swap,10187.0,467,21,11,6,32,0.38910057950305615
778,swap,10187.0,467,21,11,6,32,0.38910057950305615
779,swap,10187.0,467,21,11,6,32,0.38910057950305615
780,swap,10187.0,467,21,11,6,32,0.38910057950305615
781,swap,10187.0,467,21,11,6,32,0.38910057950305615
782,swap,10187.0,467,21,11,6,32,0.38910057950305615
783,mut_micro,10187.0,467,21,11,6,32,0.38910057950305615
784,swap,10187.0,467,21,11,6,32,0.38910057950305615
785,swap,10187.0,467,21,11,6,32,0.38910057950305615
786,swap,10187.0,467,21,11,6,32,0.38910057950305615
787,reassign,10182.0,462,21,11,6,32,0.3897447868036104
788,swap,9885.0,465,21,10,6,31,0.39133002598629824
789,swap,9885.0,465,21,10,6,31,0.39133002598629824
790,swap,9885.0,465,21,10,6,31,0.39133002598629824
791,swap,9885.0,465,21,10,6,31,0.39133002598629824
792,swap,9885.0,465,21,10,6,31,0.39133002598629824
793,swap,9885.0,465,21,10,6,31,0.39133002598629824
794,swap,9885.0,465,21,10,6,31,0.39133002598629824
795,swap,9593.0,473,21,9,6,30,0.3916280205028069
796,swap,9593.0,473,21,9,6,30,0.3916280205028069
797,swap,9593.0,473,21,9,6,30,0.3916280205028069
798,swap,9593.0,473,21,9,6,30,0.3916280205028069
799,reassign,9268.0,468,20,9,5,29,0.3927148095010362
800,swap,9268.0,468,20,9,5,29,0.3927148095010362
801,swap,9268.0,468,20,9,5,29,0.3927148095010362
802,swap,9268.0,468,20,9,5,29,0.3927148095010362
803,swap,9268.0,468,20,9,5,29,0.3927148095010362
804,swap,9268.0,468,20,9,5,29,0.3927148095010362
805,swap,9268.0,468,20,9,5,29,0.3927148095010362
806,swap,9268.0,468,20,9,5,29,0.3927148095010362
807,swap,9268.0,468,20,9,5,29,0.3927148095010362
808,swap,9268.0,468,20,9,5,29,0.3927148095010362
809,swap,9268.0,468,20,9,5,29,0.3927148095010362
810,swap,9268.0,468,20,9,5,29,0.3927148095010362
811,swap,9268.0,468,20,9,5,29,0.3927148095010362
812,swap,9268.0,468,20,9,5,29,0.3927148095010362
813,swap,9268.0,468,20,9,5,29,0.3927148095010362
814,swap,9268.0,468,20,9,5,29,0.3927148095010362
815,swap,9268.0,468,20,9,5,29,0.3927148095010362
816,swap,9268.0,468,20,9,5,29,0.3927148095010362
817,swap,9268.0,468,20,9,5,29,0.3927148095010362
818,swap,9268.0,468,20,9,5,29,0.3927148095010362
819,swap,9268.0,468,20,9,5,29,0.3927148095010362
820,swap,9268.0,468,20,9,5,29,0.3927148095010362
821,swap,9268.0,468,20,9,5,29,0.3927148095010362
822,swap,9268.0,468,20,9,5,29,0.3927148095010362
823,swap,9268.0,468,20,9,5,29,0.3927148095010362
824,swap,9268.0,468,20,9,5,29,0.3927148095010362
825,swap,9268.0,468,20,9,5,29,0.3927148095010362
826,swap,9268.0,468,20,9,5,29,0.3927148095010362
827,swap,9268.0,468,20,9,5,29,0.3927148095010362
828,swap,9268.0,468,20,9,5,29,0.3927148095010362
829,swap,9268.0,468,20,9,5,29,0.3927148095010362
830,swap,9268.0,468,20,9,5,29,0.3927148095010362
831,swap,9268.0,468,20,9,5,29,0.3927148095010362
832,swap,9268.0,468,20,9,5,29,0.3927148095010362
833,swap,9268.0,468,20,9,5,29,0.3927148095010362
834,swap,9268.0,468,20,9,5,29,0.3927148095010362
835,swap,9268.0,468,20,9,5,29,0.3927148095010362
836,swap,9268.0,468,20,9,5,29,0.3927148095010362
837,swap,9268.0,468,20,9,5,29,0.3927148095010362
838,swap,9268.0,468,20,9,5,29,0.3927148095010362
839,swap,9268.0,468,20,9,5,29,0.3927148095010362
840,mut_micro,9268.0,468,20,9,5,29,0.3927148095010362
841,swap,9268.0,468,20,9,5,29,0.3927148095010362
842,swap,9268.0,468,20,9,5,29,0.3927148095010362
843,swap,9268.0,468,20,9,5,29,0.3927148095010362
844,swap,9268.0,468,20,9,5,29,0.3927148095010362
845,reassign,9268.0,468,20,9,5,29,0.3927148095010362
846,mut_micro,9266.0,466,20,9,5,29,0.3909709044908286
847,swap,9266.0,466,20,9,5,29,0.3909709044908286
848,swap,9266.0,466,20,9,5,29,0.3909709044908286
849,swap,9266.0,466,20,9,5,29,0.3909709044908286
850,swap,9266.0,466,20,9,5,29,0.3909709044908286
851,swap,9266.0,466,20,9,5,29,0.3909709044908286
852,swap,9266.0,466,20,9,5,29,0.3909709044908286
853,swap,9266.0,466,20,9,5,29,0.3909709044908286
854,swap,9266.0,466,20,9,5,29,0.3909709044908286
855,swap,9266.0,466,20,9,5,29,0.3909709044908286
856,swap,9266.0,466,20,9,5,29,0.3909709044908286
857,swap,9266.0,466,20,9,5,29,0.3909709044908286
858,swap,9266.0,466,20,9,5,29,0.3909709044908286
859,swap,9266.0,466,20,9,5,29,0.3909709044908286
860,swap,9266.0,466,20,9,5,29,0.3909709044908286
861,swap,9266.0,466,20,9,5,29,0.3909709044908286
862,swap,9266.0,466,20,9,5,29,0.3909709044908286
863,swap,9266.0,466,20,9,5,29,0.3909709044908286
864,swap,9266.0,466,20,9,5,29,0.3909709044908286
865,swap,9266.0,466,20,9,5,29,0.3909709044908286
866,swap,9266.0,466,20,9,5,29,0.3909709044908286
867,swap,9266.0,466,20,9,5,29,0.3909709044908286
868,swap,9266.0,466,20,9,5,29,0.3909709044908286
869,swap,9266.0,466,20,9,5,29,0.3909709044908286
870,swap,8971.0,471,20,8,5,28,0.3900185588638747
871,swap,8971.0,471,20,8,5,28,0.3900185588638747
872,swap,8971.0,471,20,8,5,28,0.3900185588638747
873,swap,8971.0,471,20,8,5,28,0.3900185588638747
874,swap,8971.0,471,20,8,5,28,0.3900185588638747
875,swap,8971.0,471,20,8,5,28,0.3900185588638747
876,swap,8971.0,471,20,8,5,28,0.3900185588638747
877,swap,8971.0,471,20,8,5,28,0.3900185588638747
878,swap,8971.0,471,20,8,5,28,0.3900185588638747
879,swap,8971.0,471,20,8,5,28,0.3900185588638747
880,swap,8971.0,471,20,8,5,28,0.3900185588638747
881,swap,8971.0,471,20,8,5,28,0.3900185588638747
882,mut_micro,8971.0,471,20,8,5,28,0.3900185588638747
883,swap,8971.0,471,20,8,5,28,0.3900185588638747
884,swap,8969.0,469,20,8,5,28,0.3882753101240496
885,swap,8969.0,469,20,8,5,28,0.3882753101240496
886,swap,8969.0,469,20,8,5,28,0.3882753101240496
887,swap,8969.0,469,20,8,5,28,0.3882753101240496
888,swap,8969.0,469,20,8,5,28,0.3882753101240496
889,swap,8969.0,469,20,8,5,28,0.3882753101240496
890,swap,8969.0,469,20,8,5,28,0.3882753101240496
891,swap,8969.0,469,20,8,5,28,0.3882753101240496
892,swap,8969.0,469,20,8,5,28,0.3882753101240496
893,swap,8969.0,469,20,8,5,28,0.3882753101240496
894,swap,8969.0,469,20,8,5,28,0.3882753101240496
895,swap,8969.0,469,20,8,5,28,0.3882753101240496
896,swap,8969.0,469,20,8,5,28,0.3882753101240496
897,swap,8969.0,469,20,8,5,28,0.3882753101240496
898,swap,8969.0,469,20,8,5,28,0.3882753101240496
899,swap,8969.0,469,20,8,5,28,0.3882753101240496
900,swap,8969.0,469,20,8,5,28,0.3882753101240496
901,swap,8969.0,469,20,8,5,28,0.3882753101240496
902,swap,8969.0,469,20,8,5,28,0.3882753101240496
903,swap,8969.0,469,20,8,5,28,0.3882753101240496
904,swap,8969.0,469,20,8,5,28,0.3882753101240496
905,swap,8969.0,469,20,8,5,28,0.3882753101240496
906,swap,8969.0,469,20,8,5,28,0.3882753101240496
907,swap,8969.0,469,20,8,5,28,0.3882753101240496
908,swap,8969.0,469,20,8,5,28,0.3882753101240496
909,swap,8969.0,469,20,8,5,28,0.3882753101240496
910,swap,8969.0,469,20,8,5,28,0.3882753101240496
911,swap,8969.0,469,20,8,5,28,0.3882753101240496
912,swap,8969.0,469,20,8,5,28,0.3882753101240496
913,swap,8969.0,469,20,8,5,28,0.3882753101240496
914,swap,8969.0,469,20,8,5,28,0.3882753101240496
915,mut_micro,8367.0,467,18,8,5,26,0.38949749940462014
916,swap,8367.0,467,18,8,5,26,0.38949749940462014
917,swap,8367.0,467,18,8,5,26,0.38949749940462014
918,reassign,8367.0,467,18,8,5,26,0.38949749940462014
919,swap,8367.0,467,18,8,5,26,0.38949749940462014
920,swap,8367.0,467,18,8,5,26,0.38949749940462014
921,swap,8367.0,467,18,8,5,26,0.38949749940462014
922,swap,8367.0,467,18,8,5,26,0.38949749940462014
923,swap,8367.0,467,18,8,5,26,0.38949749940462014
924,swap,8367.0,467,18,8,5,26,0.38949749940462014
925,swap,8367.0,467,18,8,5,26,0.38949749940462014
926,swap,8367.0,467,18,8,5,26,0.38949749940462014
927,swap,8367.0,467,18,8,5,26,0.38949749940462014
928,swap,8367.0,467,18,8,5,26,0.38949749940462014
929,swap,8367.0,467,18,8,5,26,0.38949749940462014
930,swap,8367.0,467,18,8,5,26,0.38949749940462014
931,swap,8367.0,467,18,8,5,26,0.38949749940462014
932,swap,8367.0,467,18,8,5,26,0.38949749940462014
933,swap,8367.0,467,18,8,5,26,0.38949749940462014
934,swap,8367.0,467,18,8,5,26,0.38949749940462014
935,swap,8367.0,467,18,8,5,26,0.38949749940462014
936,swap,8367.0,467,18,8,5,26,0.38949749940462014
937,swap,8367.0,467,18,8,5,26,0.38949749940462014
938,swap,8367.0,467,18,8,5,26,0.38949749940462014
939,swap,8367.0,467,18,8,5,26,0.38949749940462014
940,swap,8367.0,467,18,8,5,26,0.38949749940462014
941,swap,8367.0,467,18,8,5,26,0.38949749940462014
942,swap,8367.0,467,18,8,5,26,0.38949749940462014
943,swap,8066.0,466,18,7,5,25,0.38899430740037955
944,swap,8066.0,466,18,7,5,25,0.38899430740037955
945,swap,8066.0,466,18,7,5,25,0.38899430740037955
946,swap,8066.0,466,18,7,5,25,0.38899430740037955
947,swap,8066.0,466,18,7,5,25,0.38899430740037955
948,swap,8066.0,466,18,7,5,25,0.38899430740037955
949,swap,8065.0,465,18,7,5,25,0.3876289471611939
950,reassign,8060.0,460,18,7,5,25,0.38814265863825853
951,swap,8060.0,460,18,7,5,25,0.38814265863825853
952,mut_micro,8060.0,460,18,7,5,25,0.38814265863825853
953,swap,8060.0,460,18,7,5,25,0.38814265863825853
954,swap,8060.0,460,18,7,5,25,0.38814265863825853
955,swap,8060.0,460,18,7,5,25,0.38814265863825853
956,swap,8060.0,460,18,7,5,25,0.38814265863825853
957,swap,8060.0,460,18,7,5,25,0.38814265863825853
958,reassign,8058.0,458,18,7,5,25,0.3860294117647059
959,reassign,8058.0,458,18,7,5,25,0.3860294117647059
960,reassign,8042.0,462,17,8,4,25,0.3841425459072518
961,reassign,8042.0,462,17,8,4,25,0.3841425459072518
962,reassign,8041.0,461,17,8,4,25,0.38258544524529176
963,reassign,8041.0,461,17,8,4,25,0.38258544524529176
964,reassign,8041.0,461,17,8,4,25,0.38258544524529176
965,reassign,8041.0,461,17,8,4,25,0.38258544524529176
966,reassign,8041.0,461,17,8,4,25,0.38258544524529176
967,reassign,8040.0,460,16,9,4,25,0.3832792959703567
968,reassign,8040.0,460,16,9,4,25,0.3832792959703567
969,reassign,8040.0,460,16,9,4,25,0.3832792959703567
970,reassign,8040.0,460,16,9,4,25,0.3832792959703567
971,reassign,8040.0,460,16,9,4,25,0.3832792959703567
972,swap,8040.0,460,16,9,4,25,0.3832792959703567
973,swap,8040.0,460,16,9,4,25,0.3832792959703567
974,swap,8040.0,460,16,9,4,25,0.3832792959703567
975,swap,8040.0,460,16,9,4,25,0.3832792959703567
976,swap,8040.0,460,16,9,4,25,0.3832792959703567
977,swap,8040.0,460,16,9,4,25,0.3832792959703567
978,swap,8040.0,460,16,9,4,25,0.3832792959703567
979,swap,8040.0,460,16,9,4,25,0.3832792959703567
980,swap,8040.0,460,16,9,4,25,0.3832792959703567
981,swap,8040.0,460,16,9,4,25,0.3832792959703567
982,swap,8040.0,460,16,9,4,25,0.3832792959703567
983,swap,8040.0,460,16,9,4,25,0.3832792959703567
984,swap,8040.0,460,16,9,4,25,0.3832792959703567
985,swap,8040.0,460,16,9,4,25,0.3832792959703567
986,swap,8040.0,460,16,9,4,25,0.3832792959703567
987,reassign,8040.0,460,16,9,4,25,0.3832792959703567
988,swap,8040.0,460,16,9,4,25,0.3832792959703567
989,swap,8040.0,460,16,9,4,25,0.3832792959703567
990,swap,8040.0,460,16,9,4,25,0.3832792959703567
991,swap,8040.0,460,16,9,4,25,0.3832792959703567
992,swap,7741.0,461,16,8,4,24,0.3848329845772301
993,swap,7741.0,461,16,8,4,24,0.3848329845772301
994,swap,7741.0,461,16,8,4,24,0.3848329845772301
995,swap,7741.0,461,16,8,4,24,0.3848329845772301
996,swap,7741.0,461,16,8,4,24,0.3848329845772301
997,swap,7741.0,461,16,8,4,24,0.3848329845772301
998,swap,7738.0,458,16,8,4,24,0.3872549019607843
999,swap,7738.0,458,16,8,4,24,0.3872549019607843
1000,swap,7738.0,458,16,8,4,24,0.3872549019607843
