iter,op,fitness_score,pref_penalty,capacity_viol,elig_viol,under_cap,total_violations,gini
1,swap,23841.0,341,24,54,5,78,0.26891131787835787
2,reassign,22939.0,339,23,52,5,75,0.2676339869281047
3,reassign,22939.0,339,23,52,5,75,0.2676339869281047
4,swap,22939.0,339,23,52,5,75,0.2676339869281047
5,reassign,22641.0,341,23,51,5,74,0.2668086001156495
6,reassign,22638.0,338,24,50,5,74,0.26653108051731345
7,reassign,22638.0,338,24,50,5,74,0.26653108051731345
8,swap,22638.0,338,24,50,5,74,0.26653108051731345
9,mut_micro,22040.0,340,23,49,5,72,0.2678515256369927
10,reassign,22040.0,340,23,49,5,72,0.2678515256369927
11,mut_micro,22040.0,340,23,49,5,72,0.2678515256369927
12,mut_micro,22040.0,340,23,49,5,72,0.2678515256369927
13,mut_micro,22040.0,340,23,49,5,72,0.2678515256369927
14,mut_micro,22040.0,340,23,49,5,72,0.2678515256369927
15,mut_micro,22040.0,340,23,49,5,72,0.2678515256369927
16,swap,22040.0,340,23,49,5,72,0.2678515256369927
17,reassign,22040.0,340,23,49,5,72,0.2678515256369927
18,mut_micro,22037.0,337,22,50,5,72,0.26751443282883425
19,mut_micro,22037.0,337,22,50,5,72,0.26751443282883425
20,mut_micro,21436.0,336,20,50,5,70,0.2672476397966596
21,mut_micro,21135.0,335,19,50,5,69,0.2661027471674685
22,mut_micro,21135.0,335,19,50,5,69,0.2661027471674685
23,swap,21135.0,335,19,50,5,69,0.2661027471674685
24,mut_micro,21131.0,331,19,50,5,69,0.2638867557466852
25,mut_micro,21131.0,331,19,50,5,69,0.2638867557466852
26,mut_micro,21131.0,331,19,50,5,69,0.2638867557466852
27,mut_micro,20534.0,334,19,48,5,67,0.2670278637770897
28,mut_micro,20534.0,334,19,48,5,67,0.2670278637770897
29,mut_micro,20189.0,329,17,49,3,66,0.262261268143621
30,mut_micro,20189.0,329,17,49,3,66,0.262261268143621
31,mut_micro,20188.0,328,18,48,3,66,0.25972772528700605
32,mut_micro,20188.0,328,18,48,3,66,0.25972772528700605
33,mut_micro,20188.0,328,18,48,3,66,0.25972772528700605
34,mut_micro,19606.0,326,18,46,4,64,0.25687285223367695
35,mut_micro,19310.0,330,17,46,4,63,0.26256127450980393
36,mut_micro,19310.0,330,17,46,4,63,0.26256127450980393
37,mut_micro,19310.0,330,17,46,4,63,0.26256127450980393
38,mut_micro,19310.0,330,17,46,4,63,0.26256127450980393
39,mut_micro,19310.0,330,17,46,4,63,0.26256127450980393
40,mut_micro,19310.0,330,17,46,4,63,0.26256127450980393
41,mut_micro,19309.0,329,17,46,4,63,0.2633817163228927
42,mut_micro,19007.0,327,17,45,4,62,0.26384455591021905
43,mut_micro,19007.0,327,17,45,4,62,0.26384455591021905
44,mut_micro,19007.0,327,17,45,4,62,0.26384455591021905
45,mut_micro,19007.0,327,17,45,4,62,0.26384455591021905
46,mut_micro,18705.0,325,17,44,4,61,0.25966530571097324
47,mut_micro,18705.0,325,17,44,4,61,0.25966530571097324
48,mut_micro,18705.0,325,17,44,4,61,0.25966530571097324
49,reassign,18705.0,325,17,44,4,61,0.25966530571097324
50,mut_micro,18705.0,325,17,44,4,61,0.25966530571097324
51,mut_micro,18705.0,325,17,44,4,61,0.25966530571097324
52,mut_micro,18705.0,325,17,44,4,61,0.25966530571097324
53,mut_micro,18702.0,322,17,44,4,61,0.2564525810324126
54,mut_micro,18702.0,322,17,44,4,61,0.2564525810324126
55,mut_micro,18663.0,323,16,45,2,61,0.2581365026829147
56,reassign,18663.0,323,16,45,2,61,0.2581365026829147
57,mut_micro,18663.0,323,16,45,2,61,0.2581365026829147
58,mut_micro,18663.0,323,16,45,2,61,0.2581365026829147
59,reassign,18663.0,323,16,45,2,61,0.2581365026829147
60,mut_micro,18663.0,323,16,45,2,61,0.2581365026829147
61,mut_micro,18663.0,323,16,45,2,61,0.2581365026829147
62,mut_micro,18663.0,323,16,45,2,61,0.2581365026829147
63,mut_micro,18663.0,323,16,45,2,61,0.2581365026829147
64,mut_micro,18663.0,323,16,45,2,61,0.2581365026829147
65,mut_micro,18663.0,323,16,45,2,61,0.2581365026829147
66,mut_micro,18663.0,323,16,45,2,61,0.2581365026829147
67,mut_micro,18663.0,323,16,45,2,61,0.2581365026829147
68,mut_micro,18658.0,318,16,45,2,61,0.2530699148346208
69,mut_micro,18355.0,315,16,44,2,60,0.24760430487984672
70,mut_micro,18336.0,316,15,45,1,60,0.24687161296679486
71,mut_micro,18336.0,316,15,45,1,60,0.24687161296679486
72,mut_micro,18336.0,316,15,45,1,60,0.24687161296679486
73,mut_micro,18336.0,316,15,45,1,60,0.24687161296679486
74,mut_micro,18336.0,316,15,45,1,60,0.24687161296679486
75,mut_micro,18336.0,316,15,45,1,60,0.24687161296679486
76,mut_micro,18336.0,316,15,45,1,60,0.24687161296679486
77,mut_micro,18336.0,316,15,45,1,60,0.24687161296679486
78,mut_micro,18336.0,316,15,45,1,60,0.24687161296679486
79,swap,18336.0,316,15,45,1,60,0.24687161296679486
80,swap,18336.0,316,15,45,1,60,0.24687161296679486
81,swap,18336.0,316,15,45,1,60,0.24687161296679486
82,swap,18336.0,316,15,45,1,60,0.24687161296679486
83,swap,18336.0,316,15,45,1,60,0.24687161296679486
84,swap,18042.0,322,15,44,1,59,0.25445178071228475
85,swap,18042.0,322,15,44,1,59,0.25445178071228475
86,swap,18042.0,322,15,44,1,59,0.25445178071228475
87,swap,18042.0,322,15,44,1,59,0.25445178071228475
88,swap,18042.0,322,15,44,1,59,0.25445178071228475
89,swap,18042.0,322,15,44,1,59,0.25445178071228475
90,swap,17747.0,327,15,43,1,58,0.25938592491260054
91,swap,17453.0,333,15,42,1,57,0.2700581544953941
92,swap,17453.0,333,15,42,1,57,0.2700581544953941
93,swap,17453.0,333,15,42,1,57,0.2700581544953941
94,swap,17453.0,333,15,42,1,57,0.2700581544953941
95,swap,17453.0,333,15,42,1,57,0.2700581544953941
96,swap,17453.0,333,15,42,1,57,0.2700581544953941
97,swap,17156.0,336,15,41,1,56,0.276532835356365
98,swap,17156.0,336,15,41,1,56,0.276532835356365
99,swap,16564.0,344,15,39,1,54,0.2863275039745629
100,swap,16564.0,344,15,39,1,54,0.2863275039745629
101,swap,16271.0,351,15,38,1,53,0.29668341165667383
102,swap,16271.0,351,15,38,1,53,0.29668341165667383
103,swap,15975.0,355,15,37,1,52,0.3038669506799935
104,swap,15975.0,355,15,37,1,52,0.3038669506799935
105,swap,15680.0,360,15,36,1,51,0.3081311620693476
106,swap,15388.0,368,15,35,1,50,0.3168990139408364
107,swap,15388.0,368,15,35,1,50,0.3168990139408364
108,reassign,15388.0,368,15,35,1,50,0.3168990139408364
109,swap,15388.0,368,15,35,1,50,0.3168990139408364
110,swap,15388.0,368,15,35,1,50,0.3168990139408364
111,swap,15388.0,368,15,35,1,50,0.3168990139408364
112,swap,15388.0,368,15,35,1,50,0.3168990139408364
113,swap,15388.0,368,15,35,1,50,0.3168990139408364
114,swap,15097.0,377,15,34,1,49,0.3255076511316694
115,swap,15097.0,377,15,34,1,49,0.3255076511316694
116,swap,15097.0,377,15,34,1,49,0.3255076511316694
117,swap,15097.0,377,15,34,1,49,0.3255076511316694
118,swap,15095.0,375,15,34,1,49,0.3262479032911098
119,swap,15095.0,375,15,34,1,49,0.3262479032911098
120,swap,15095.0,375,15,34,1,49,0.3262479032911098
121,mut_micro,15095.0,375,15,34,1,49,0.3262479032911098
122,swap,15095.0,375,15,34,1,49,0.3262479032911098
123,swap,15095.0,375,15,34,1,49,0.3262479032911098
124,swap,14803.0,383,15,33,1,48,0.33543628931935315
125,swap,14803.0,383,15,33,1,48,0.33543628931935315
126,swap,14803.0,383,15,33,1,48,0.33543628931935315
127,swap,14803.0,383,15,33,1,48,0.33543628931935315
128,swap,14803.0,383,15,33,1,48,0.33543628931935315
129,swap,14803.0,383,15,33,1,48,0.33543628931935315
130,swap,14803.0,383,15,33,1,48,0.33543628931935315
131,swap,14803.0,383,15,33,1,48,0.33543628931935315
132,swap,14803.0,383,15,33,1,48,0.33543628931935315
133,swap,14803.0,383,15,33,1,48,0.33543628931935315
134,swap,14803.0,383,15,33,1,48,0.33543628931935315
135,swap,14803.0,383,15,33,1,48,0.33543628931935315
136,swap,14803.0,383,15,33,1,48,0.33543628931935315
137,mut_micro,14803.0,383,15,33,1,48,0.33543628931935315
138,swap,14803.0,383,15,33,1,48,0.33543628931935315
139,swap,14803.0,383,15,33,1,48,0.33543628931935315
140,swap,14803.0,383,15,33,1,48,0.33543628931935315
141,swap,14803.0,383,15,33,1,48,0.33543628931935315
142,swap,14803.0,383,15,33,1,48,0.33543628931935315
143,swap,14506.0,386,15,32,1,47,0.33967001434720223
144,swap,14506.0,386,15,32,1,47,0.33967001434720223
145,swap,14211.0,391,15,31,1,46,0.3430158441085412
146,swap,14211.0,391,15,31,1,46,0.3430158441085412
147,swap,14211.0,391,15,31,1,46,0.3430158441085412
148,swap,14211.0,391,15,31,1,46,0.3430158441085412
149,swap,14211.0,391,15,31,1,46,0.3430158441085412
150,swap,14211.0,391,15,31,1,46,0.3430158441085412
151,swap,14211.0,391,15,31,1,46,0.3430158441085412
152,swap,14211.0,391,15,31,1,46,0.3430158441085412
153,swap,14211.0,391,15,31,1,46,0.3430158441085412
154,swap,14211.0,391,15,31,1,46,0.3430158441085412
155,swap,14211.0,391,15,31,1,46,0.3430158441085412
156,swap,14211.0,391,15,31,1,46,0.3430158441085412
157,swap,14211.0,391,15,31,1,46,0.3430158441085412
158,swap,14211.0,391,15,31,1,46,0.3430158441085412
159,swap,14211.0,391,15,31,1,46,0.3430158441085412
160,reassign,14211.0,391,15,31,1,46,0.3430158441085412
161,swap,14211.0,391,15,31,1,46,0.3430158441085412
162,swap,14211.0,391,15,31,1,46,0.3430158441085412
163,swap,14211.0,391,15,31,1,46,0.3430158441085412
164,swap,14211.0,391,15,31,1,46,0.3430158441085412
165,swap,14211.0,391,15,31,1,46,0.3430158441085412
166,swap,14211.0,391,15,31,1,46,0.3430158441085412
167,swap,13910.0,390,15,30,1,45,0.3441055434519486
168,swap,13910.0,390,15,30,1,45,0.3441055434519486
169,swap,13910.0,390,15,30,1,45,0.3441055434519486
170,swap,13910.0,390,15,30,1,45,0.3441055434519486
171,swap,13910.0,390,15,30,1,45,0.3441055434519486
172,swap,13910.0,390,15,30,1,45,0.3441055434519486
173,swap,13910.0,390,15,30,1,45,0.3441055434519486
174,swap,13910.0,390,15,30,1,45,0.3441055434519486
175,swap,13910.0,390,15,30,1,45,0.3441055434519486
176,swap,13910.0,390,15,30,1,45,0.3441055434519486
177,swap,13910.0,390,15,30,1,45,0.3441055434519486
178,swap,13910.0,390,15,30,1,45,0.3441055434519486
179,swap,13910.0,390,15,30,1,45,0.3441055434519486
180,swap,13910.0,390,15,30,1,45,0.3441055434519486
181,swap,13910.0,390,15,30,1,45,0.3441055434519486
182,swap,13910.0,390,15,30,1,45,0.3441055434519486
183,swap,13910.0,390,15,30,1,45,0.3441055434519486
184,swap,13910.0,390,15,30,1,45,0.3441055434519486
185,swap,13907.0,387,15,30,1,45,0.34397673442465676
186,swap,13907.0,387,15,30,1,45,0.34397673442465676
187,swap,13907.0,387,15,30,1,45,0.34397673442465676
188,swap,13907.0,387,15,30,1,45,0.34397673442465676
189,swap,13907.0,387,15,30,1,45,0.34397673442465676
190,swap,13907.0,387,15,30,1,45,0.34397673442465676
191,swap,13907.0,387,15,30,1,45,0.34397673442465676
192,swap,13907.0,387,15,30,1,45,0.34397673442465676
193,swap,13907.0,387,15,30,1,45,0.34397673442465676
194,mut_micro,13609.0,389,16,28,1,44,0.34325791855203613
195,swap,13609.0,389,16,28,1,44,0.34325791855203613
196,swap,13609.0,389,16,28,1,44,0.34325791855203613
197,swap,13609.0,389,16,28,1,44,0.34325791855203613
198,swap,13609.0,389,16,28,1,44,0.34325791855203613
199,swap,13609.0,389,16,28,1,44,0.34325791855203613
200,reassign,13609.0,389,16,28,1,44,0.34325791855203613
201,swap,13609.0,389,16,28,1,44,0.34325791855203613
202,swap,13609.0,389,16,28,1,44,0.34325791855203613
203,mut_micro,13314.0,394,14,29,1,43,0.34650735294117646
204,swap,13314.0,394,14,29,1,43,0.34650735294117646
205,swap,13314.0,394,14,29,1,43,0.34650735294117646
206,swap,13011.0,391,14,28,1,42,0.3411946822072482
207,swap,13011.0,391,14,28,1,42,0.3411946822072482
208,swap,13011.0,391,14,28,1,42,0.3411946822072482
209,swap,13011.0,391,14,28,1,42,0.3411946822072482
210,swap,13011.0,391,14,28,1,42,0.3411946822072482
211,swap,13011.0,391,14,28,1,42,0.3411946822072482
212,swap,13011.0,391,14,28,1,42,0.3411946822072482
213,swap,13011.0,391,14,28,1,42,0.3411946822072482
214,swap,13011.0,391,14,28,1,42,0.3411946822072482
215,swap,13011.0,391,14,28,1,42,0.3411946822072482
216,swap,13011.0,391,14,28,1,42,0.3411946822072482
217,mut_micro,13011.0,391,14,28,1,42,0.3411946822072482
218,reassign,13011.0,391,14,28,1,42,0.3411946822072482
219,swap,13011.0,391,14,28,1,42,0.3411946822072482
220,swap,13011.0,391,14,28,1,42,0.3411946822072482
221,swap,13011.0,391,14,28,1,42,0.3411946822072482
222,swap,13011.0,391,14,28,1,42,0.3411946822072482
223,swap,12719.0,399,14,27,1,41,0.3494864612511671
224,swap,12719.0,399,14,27,1,41,0.3494864612511671
225,swap,12719.0,399,14,27,1,41,0.3494864612511671
226,swap,12719.0,399,14,27,1,41,0.3494864612511671
227,swap,12719.0,399,14,27,1,41,0.3494864612511671
228,swap,12719.0,399,14,27,1,41,0.3494864612511671
229,swap,12718.0,398,14,27,1,41,0.3494043186895011
230,swap,12421.0,401,14,26,1,40,0.35146902211363773
231,swap,12421.0,401,14,26,1,40,0.35146902211363773
232,swap,12421.0,401,14,26,1,40,0.35146902211363773
233,swap,12421.0,401,14,26,1,40,0.35146902211363773
234,swap,12421.0,401,14,26,1,40,0.35146902211363773
235,swap,12421.0,401,14,26,1,40,0.35146902211363773
236,swap,12129.0,409,14,25,1,39,0.35792349726775957
237,swap,12129.0,409,14,25,1,39,0.35792349726775957
238,swap,12129.0,409,14,25,1,39,0.35792349726775957
239,swap,12128.0,408,14,25,1,39,0.3568499295142894
240,swap,12126.0,406,14,25,1,39,0.3537687802393684
241,mut_micro,12126.0,406,14,25,1,39,0.3537687802393684
242,swap,12126.0,406,14,25,1,39,0.3537687802393684
243,mut_micro,12126.0,406,14,25,1,39,0.3537687802393684
244,swap,12126.0,406,14,25,1,39,0.3537687802393684
245,swap,12126.0,406,14,25,1,39,0.3537687802393684
246,swap,12126.0,406,14,25,1,39,0.3537687802393684
247,swap,12126.0,406,14,25,1,39,0.3537687802393684
248,swap,11831.0,411,14,24,1,38,0.3562738626803857
249,swap,11831.0,411,14,24,1,38,0.3562738626803857
250,swap,11826.0,406,14,24,1,38,0.3537687802393684
251,reassign,11826.0,406,14,24,1,38,0.3537687802393684
252,swap,11826.0,406,14,24,1,38,0.3537687802393684
253,swap,11826.0,406,14,24,1,38,0.3537687802393684
254,swap,11826.0,406,14,24,1,38,0.3537687802393684
255,swap,11826.0,406,14,24,1,38,0.3537687802393684
256,swap,11532.0,412,14,23,1,37,0.35820023373587845
257,swap,11532.0,412,14,23,1,37,0.35820023373587845
258,swap,11532.0,412,14,23,1,37,0.35820023373587845
259,swap,11532.0,412,14,23,1,37,0.35820023373587845
260,swap,11532.0,412,14,23,1,37,0.35820023373587845
261,swap,11532.0,412,14,23,1,37,0.35820023373587845
262,swap,11234.0,414,14,22,1,36,0.3611764705882352
263,swap,11234.0,414,14,22,1,36,0.3611764705882352
264,swap,11234.0,414,14,22,1,36,0.3611764705882352
265,swap,11234.0,414,14,22,1,36,0.3611764705882352
266,swap,11234.0,414,14,22,1,36,0.3611764705882352
267,swap,11234.0,414,14,22,1,36,0.3611764705882352
268,swap,11234.0,414,14,22,1,36,0.3611764705882352
269,swap,11234.0,414,14,22,1,36,0.3611764705882352
270,swap,11234.0,414,14,22,1,36,0.3611764705882352
271,swap,11234.0,414,14,22,1,36,0.3611764705882352
272,swap,11234.0,414,14,22,1,36,0.3611764705882352
273,swap,11234.0,414,14,22,1,36,0.3611764705882352
274,swap,11234.0,414,14,22,1,36,0.3611764705882352
275,swap,11233.0,413,14,22,1,36,0.3592925542309948
276,swap,11233.0,413,14,22,1,36,0.3592925542309948
277,swap,11233.0,413,14,22,1,36,0.3592925542309948
278,swap,11233.0,413,14,22,1,36,0.3592925542309948
279,swap,11233.0,413,14,22,1,36,0.3592925542309948
280,swap,11233.0,413,14,22,1,36,0.3592925542309948
281,swap,11233.0,413,14,22,1,36,0.3592925542309948
282,swap,11233.0,413,14,22,1,36,0.3592925542309948
283,swap,11233.0,413,14,22,1,36,0.3592925542309948
284,swap,11233.0,413,14,22,1,36,0.3592925542309948
285,swap,11233.0,413,14,22,1,36,0.3592925542309948
286,swap,11233.0,413,14,22,1,36,0.3592925542309948
287,swap,11233.0,413,14,22,1,36,0.3592925542309948
288,swap,11233.0,413,14,22,1,36,0.3592925542309948
289,swap,11233.0,413,14,22,1,36,0.3592925542309948
290,swap,11230.0,410,14,22,1,36,0.3575206398348813
291,swap,11230.0,410,14,22,1,36,0.3575206398348813
292,swap,11230.0,410,14,22,1,36,0.3575206398348813
293,swap,11230.0,410,14,22,1,36,0.3575206398348813
294,swap,11230.0,410,14,22,1,36,0.3575206398348813
295,swap,11230.0,410,14,22,1,36,0.3575206398348813
296,swap,11230.0,410,14,22,1,36,0.3575206398348813
297,swap,11230.0,410,14,22,1,36,0.3575206398348813
298,swap,11230.0,410,14,22,1,36,0.3575206398348813
299,swap,11230.0,410,14,22,1,36,0.3575206398348813
300,swap,11230.0,410,14,22,1,36,0.3575206398348813
301,swap,11230.0,410,14,22,1,36,0.3575206398348813
302,swap,11230.0,410,14,22,1,36,0.3575206398348813
303,swap,11230.0,410,14,22,1,36,0.3575206398348813
304,swap,11230.0,410,14,22,1,36,0.3575206398348813
305,swap,11230.0,410,14,22,1,36,0.3575206398348813
306,mut_micro,11230.0,410,14,22,1,36,0.3575206398348813
307,swap,11230.0,410,14,22,1,36,0.3575206398348813
308,swap,11230.0,410,14,22,1,36,0.3575206398348813
309,swap,11230.0,410,14,22,1,36,0.3575206398348813
310,swap,11230.0,410,14,22,1,36,0.3575206398348813
311,swap,11230.0,410,14,22,1,36,0.3575206398348813
312,swap,11230.0,410,14,22,1,36,0.3575206398348813
313,swap,11230.0,410,14,22,1,36,0.3575206398348813
314,swap,11230.0,410,14,22,1,36,0.3575206398348813
315,swap,11230.0,410,14,22,1,36,0.3575206398348813
316,swap,11230.0,410,14,22,1,36,0.3575206398348813
317,swap,11229.0,409,14,22,1,36,0.3568306010928961
318,swap,11229.0,409,14,22,1,36,0.3568306010928961
319,swap,11229.0,409,14,22,1,36,0.3568306010928961
320,swap,11229.0,409,14,22,1,36,0.3568306010928961
321,swap,11229.0,409,14,22,1,36,0.3568306010928961
322,swap,11229.0,409,14,22,1,36,0.3568306010928961
323,swap,11229.0,409,14,22,1,36,0.3568306010928961
324,swap,11225.0,405,14,22,1,36,0.3529729043721049
325,swap,11225.0,405,14,22,1,36,0.3529729043721049
326,swap,11225.0,405,14,22,1,36,0.3529729043721049
327,swap,11225.0,405,14,22,1,36,0.3529729043721049
328,swap,11225.0,405,14,22,1,36,0.3529729043721049
329,swap,11225.0,405,14,22,1,36,0.3529729043721049
330,swap,11225.0,405,14,22,1,36,0.3529729043721049
331,swap,11225.0,405,14,22,1,36,0.3529729043721049
332,swap,11225.0,405,14,22,1,36,0.3529729043721049
333,swap,11225.0,405,14,22,1,36,0.3529729043721049
334,swap,11225.0,405,14,22,1,36,0.3529729043721049
335,swap,11225.0,405,14,22,1,36,0.3529729043721049
336,swap,11225.0,405,14,22,1,36,0.3529729043721049
337,swap,11225.0,405,14,22,1,36,0.3529729043721049
338,swap,11225.0,405,14,22,1,36,0.3529729043721049
339,swap,11225.0,405,14,22,1,36,0.3529729043721049
340,swap,11225.0,405,14,22,1,36,0.3529729043721049
341,swap,11225.0,405,14,22,1,36,0.3529729043721049
342,swap,11225.0,405,14,22,1,36,0.3529729043721049
343,swap,10929.0,409,14,21,1,35,0.3568306010928961
344,swap,10929.0,409,14,21,1,35,0.3568306010928961
345,swap,10929.0,409,14,21,1,35,0.3568306010928961
346,swap,10929.0,409,14,21,1,35,0.3568306010928961
347,swap,10929.0,409,14,21,1,35,0.3568306010928961
348,swap,10929.0,409,14,21,1,35,0.3568306010928961
349,swap,10929.0,409,14,21,1,35,0.3568306010928961
350,swap,10929.0,409,14,21,1,35,0.3568306010928961
351,swap,10929.0,409,14,21,1,35,0.3568306010928961
352,swap,10929.0,409,14,21,1,35,0.3568306010928961
353,swap,10929.0,409,14,21,1,35,0.3568306010928961
354,swap,10929.0,409,14,21,1,35,0.3568306010928961
355,swap,10929.0,409,14,21,1,35,0.3568306010928961
356,swap,10928.0,408,14,21,1,35,0.3580674099705243
357,swap,10928.0,408,14,21,1,35,0.3580674099705243
358,swap,10928.0,408,14,21,1,35,0.3580674099705243
359,swap,10928.0,408,14,21,1,35,0.3580674099705243
360,swap,10928.0,408,14,21,1,35,0.3580674099705243
361,swap,10928.0,408,14,21,1,35,0.3580674099705243
362,swap,10928.0,408,14,21,1,35,0.3580674099705243
363,swap,10928.0,408,14,21,1,35,0.3580674099705243
364,swap,10928.0,408,14,21,1,35,0.3580674099705243
365,swap,10928.0,408,14,21,1,35,0.3580674099705243
366,swap,10630.0,410,14,20,1,34,0.3610036119711042
367,mut_micro,10630.0,410,14,20,1,34,0.3610036119711042
368,swap,10630.0,410,14,20,1,34,0.3610036119711042
369,swap,10630.0,410,14,20,1,34,0.3610036119711042
370,swap,10630.0,410,14,20,1,34,0.3610036119711042
371,swap,10630.0,410,14,20,1,34,0.3610036119711042
372,swap,10630.0,410,14,20,1,34,0.3610036119711042
373,swap,10630.0,410,14,20,1,34,0.3610036119711042
374,swap,10630.0,410,14,20,1,34,0.3610036119711042
375,swap,10630.0,410,14,20,1,34,0.3610036119711042
376,swap,10630.0,410,14,20,1,34,0.3610036119711042
377,swap,10630.0,410,14,20,1,34,0.3610036119711042
378,swap,10630.0,410,14,20,1,34,0.3610036119711042
379,swap,10630.0,410,14,20,1,34,0.3610036119711042
380,swap,10630.0,410,14,20,1,34,0.3610036119711042
381,swap,10630.0,410,14,20,1,34,0.3610036119711042
382,swap,10630.0,410,14,20,1,34,0.3610036119711042
383,swap,10630.0,410,14,20,1,34,0.3610036119711042
384,swap,10630.0,410,14,20,1,34,0.3610036119711042
385,swap,10630.0,410,14,20,1,34,0.3610036119711042
386,swap,10630.0,410,14,20,1,34,0.3610036119711042
387,swap,10630.0,410,14,20,1,34,0.3610036119711042
388,swap,10630.0,410,14,20,1,34,0.3610036119711042
389,swap,10335.0,415,14,19,1,33,0.36340087874614724
390,swap,10335.0,415,14,19,1,33,0.36340087874614724
391,swap,10335.0,415,14,19,1,33,0.36340087874614724
392,swap,10335.0,415,14,19,1,33,0.36340087874614724
393,swap,10335.0,415,14,19,1,33,0.36340087874614724
394,swap,10335.0,415,14,19,1,33,0.36340087874614724
395,swap,10335.0,415,14,19,1,33,0.36340087874614724
396,swap,10335.0,415,14,19,1,33,0.36340087874614724
397,swap,10035.0,415,14,18,1,32,0.36340087874614724
398,swap,10035.0,415,14,18,1,32,0.36340087874614724
399,swap,10035.0,415,14,18,1,32,0.36340087874614724
400,swap,10035.0,415,14,18,1,32,0.36340087874614724
401,swap,9736.0,416,14,17,1,31,0.3634030793525464
402,reassign,9736.0,416,14,17,1,31,0.3634030793525464
403,swap,9736.0,416,14,17,1,31,0.3634030793525464
404,swap,9736.0,416,14,17,1,31,0.3634030793525464
405,swap,9736.0,416,14,17,1,31,0.3634030793525464
406,swap,9736.0,416,14,17,1,31,0.3634030793525464
407,swap,9736.0,416,14,17,1,31,0.3634030793525464
408,swap,9736.0,416,14,17,1,31,0.3634030793525464
409,swap,9736.0,416,14,17,1,31,0.3634030793525464
410,swap,9736.0,416,14,17,1,31,0.3634030793525464
411,swap,9736.0,416,14,17,1,31,0.3634030793525464
412,swap,9736.0,416,14,17,1,31,0.3634030793525464
413,swap,9736.0,416,14,17,1,31,0.3634030793525464
414,swap,9736.0,416,14,17,1,31,0.3634030793525464
415,swap,9736.0,416,14,17,1,31,0.3634030793525464
416,swap,9736.0,416,14,17,1,31,0.3634030793525464
417,swap,9736.0,416,14,17,1,31,0.3634030793525464
418,swap,9736.0,416,14,17,1,31,0.3634030793525464
419,swap,9736.0,416,14,17,1,31,0.3634030793525464
420,swap,9736.0,416,14,17,1,31,0.3634030793525464
421,swap,9736.0,416,14,17,1,31,0.3634030793525464
422,swap,9736.0,416,14,17,1,31,0.3634030793525464
423,swap,9736.0,416,14,17,1,31,0.3634030793525464
424,swap,9736.0,416,14,17,1,31,0.3634030793525464
425,swap,9736.0,416,14,17,1,31,0.3634030793525464
426,swap,9735.0,415,14,17,1,31,0.3626795199685225
427,swap,9735.0,415,14,17,1,31,0.3626795199685225
428,swap,9735.0,415,14,17,1,31,0.3626795199685225
429,swap,9735.0,415,14,17,1,31,0.3626795199685225
430,swap,9735.0,415,14,17,1,31,0.3626795199685225
431,mut_micro,9432.0,412,13,17,1,30,0.36086222568497606
432,swap,9432.0,412,13,17,1,30,0.36086222568497606
433,swap,9432.0,412,13,17,1,30,0.36086222568497606
434,swap,9432.0,412,13,17,1,30,0.36086222568497606
435,swap,9432.0,412,13,17,1,30,0.36086222568497606
436,swap,9432.0,412,13,17,1,30,0.36086222568497606
437,reassign,9432.0,412,13,17,1,30,0.36086222568497606
438,swap,9134.0,414,13,16,1,29,0.36366013071895426
439,swap,9134.0,414,13,16,1,29,0.36366013071895426
440,swap,9134.0,414,13,16,1,29,0.36366013071895426
441,swap,9134.0,414,13,16,1,29,0.36366013071895426
442,swap,8833.0,413,13,15,1,28,0.36359194840727
443,swap,8833.0,413,13,15,1,28,0.36359194840727
444,swap,8833.0,413,13,15,1,28,0.36359194840727
445,swap,8833.0,413,13,15,1,28,0.36359194840727
446,swap,8828.0,408,13,15,1,28,0.36107907215173657
447,swap,8828.0,408,13,15,1,28,0.36107907215173657
448,swap,8828.0,408,13,15,1,28,0.36107907215173657
449,swap,8828.0,408,13,15,1,28,0.36107907215173657
450,swap,8828.0,408,13,15,1,28,0.36107907215173657
451,swap,8828.0,408,13,15,1,28,0.36107907215173657
452,swap,8828.0,408,13,15,1,28,0.36107907215173657
453,swap,8828.0,408,13,15,1,28,0.36107907215173657
454,reassign,8828.0,408,13,15,1,28,0.36107907215173657
455,reassign,8828.0,408,13,15,1,28,0.36107907215173657
456,swap,8828.0,408,13,15,1,28,0.36107907215173657
457,swap,8828.0,408,13,15,1,28,0.36107907215173657
458,swap,8828.0,408,13,15,1,28,0.36107907215173657
459,swap,8828.0,408,13,15,1,28,0.36107907215173657
460,swap,8828.0,408,13,15,1,28,0.36107907215173657
461,swap,8828.0,408,13,15,1,28,0.36107907215173657
462,swap,8828.0,408,13,15,1,28,0.36107907215173657
463,swap,8828.0,408,13,15,1,28,0.36107907215173657
464,swap,8828.0,408,13,15,1,28,0.36107907215173657
465,swap,8828.0,408,13,15,1,28,0.36107907215173657
466,swap,8828.0,408,13,15,1,28,0.36107907215173657
467,swap,8828.0,408,13,15,1,28,0.36107907215173657
468,swap,8828.0,408,13,15,1,28,0.36107907215173657
469,swap,8828.0,408,13,15,1,28,0.36107907215173657
470,swap,8828.0,408,13,15,1,28,0.36107907215173657
471,swap,8828.0,408,13,15,1,28,0.36107907215173657
472,swap,8828.0,408,13,15,1,28,0.36107907215173657
473,swap,8828.0,408,13,15,1,28,0.36107907215173657
474,swap,8828.0,408,13,15,1,28,0.36107907215173657
475,swap,8828.0,408,13,15,1,28,0.36107907215173657
476,swap,8828.0,408,13,15,1,28,0.36107907215173657
477,swap,8828.0,408,13,15,1,28,0.36107907215173657
478,swap,8828.0,408,13,15,1,28,0.36107907215173657
479,swap,8828.0,408,13,15,1,28,0.36107907215173657
480,swap,8828.0,408,13,15,1,28,0.36107907215173657
481,swap,8828.0,408,13,15,1,28,0.36107907215173657
482,swap,8828.0,408,13,15,1,28,0.36107907215173657
483,swap,8828.0,408,13,15,1,28,0.36107907215173657
484,swap,8828.0,408,13,15,1,28,0.36107907215173657
485,swap,8528.0,408,13,14,1,27,0.36107907215173657
486,swap,8528.0,408,13,14,1,27,0.36107907215173657
487,swap,8528.0,408,13,14,1,27,0.36107907215173657
488,swap,8528.0,408,13,14,1,27,0.36107907215173657
489,swap,8527.0,407,13,14,1,27,0.3583381235230249
490,swap,8231.0,411,13,13,1,26,0.36209797450333275
491,swap,8231.0,411,13,13,1,26,0.36209797450333275
492,swap,8231.0,411,13,13,1,26,0.36209797450333275
493,swap,8231.0,411,13,13,1,26,0.36209797450333275
494,swap,8231.0,411,13,13,1,26,0.36209797450333275
495,swap,8231.0,411,13,13,1,26,0.36209797450333275
496,swap,8231.0,411,13,13,1,26,0.36209797450333275
497,swap,8231.0,411,13,13,1,26,0.36209797450333275
498,swap,8231.0,411,13,13,1,26,0.36209797450333275
499,swap,8231.0,411,13,13,1,26,0.36209797450333275
500,swap,8231.0,411,13,13,1,26,0.36209797450333275
501,swap,8231.0,411,13,13,1,26,0.36209797450333275
502,swap,8231.0,411,13,13,1,26,0.36209797450333275
503,swap,8231.0,411,13,13,1,26,0.36209797450333275
504,swap,8231.0,411,13,13,1,26,0.36209797450333275
505,swap,8231.0,411,13,13,1,26,0.36209797450333275
506,swap,8231.0,411,13,13,1,26,0.36209797450333275
507,swap,8231.0,411,13,13,1,26,0.36209797450333275
508,reassign,8231.0,411,13,13,1,26,0.36209797450333275
509,swap,8231.0,411,13,13,1,26,0.36209797450333275
510,swap,8231.0,411,13,13,1,26,0.36209797450333275
511,swap,8231.0,411,13,13,1,26,0.36209797450333275
512,swap,8231.0,411,13,13,1,26,0.36209797450333275
513,swap,8231.0,411,13,13,1,26,0.36209797450333275
514,swap,8231.0,411,13,13,1,26,0.36209797450333275
515,swap,8231.0,411,13,13,1,26,0.36209797450333275
516,swap,8231.0,411,13,13,1,26,0.36209797450333275
517,mut_micro,8231.0,411,13,13,1,26,0.36209797450333275
518,swap,8231.0,411,13,13,1,26,0.36209797450333275
519,swap,8231.0,411,13,13,1,26,0.36209797450333275
520,swap,8231.0,411,13,13,1,26,0.36209797450333275
521,swap,8231.0,411,13,13,1,26,0.36209797450333275
522,swap,8231.0,411,13,13,1,26,0.36209797450333275
523,swap,8231.0,411,13,13,1,26,0.36209797450333275
524,swap,8231.0,411,13,13,1,26,0.36209797450333275
525,swap,8231.0,411,13,13,1,26,0.36209797450333275
526,swap,8231.0,411,13,13,1,26,0.36209797450333275
527,swap,8231.0,411,13,13,1,26,0.36209797450333275
528,swap,8231.0,411,13,13,1,26,0.36209797450333275
529,swap,8231.0,411,13,13,1,26,0.36209797450333275
530,swap,8231.0,411,13,13,1,26,0.36209797450333275
531,swap,8231.0,411,13,13,1,26,0.36209797450333275
532,swap,8231.0,411,13,13,1,26,0.36209797450333275
533,swap,8231.0,411,13,13,1,26,0.36209797450333275
534,swap,8231.0,411,13,13,1,26,0.36209797450333275
535,swap,8231.0,411,13,13,1,26,0.36209797450333275
536,swap,8231.0,411,13,13,1,26,0.36209797450333275
537,reassign,8231.0,411,13,13,1,26,0.36209797450333275
538,swap,8231.0,411,13,13,1,26,0.36209797450333275
539,swap,8231.0,411,13,13,1,26,0.36209797450333275
540,swap,8231.0,411,13,13,1,26,0.36209797450333275
541,swap,8231.0,411,13,13,1,26,0.36209797450333275
542,swap,8231.0,411,13,13,1,26,0.36209797450333275
543,swap,8231.0,411,13,13,1,26,0.36209797450333275
544,swap,8231.0,411,13,13,1,26,0.36209797450333275
545,swap,8231.0,411,13,13,1,26,0.36209797450333275
546,swap,8231.0,411,13,13,1,26,0.36209797450333275
547,swap,8231.0,411,13,13,1,26,0.36209797450333275
548,swap,8231.0,411,13,13,1,26,0.36209797450333275
549,swap,8231.0,411,13,13,1,26,0.36209797450333275
550,swap,8231.0,411,13,13,1,26,0.36209797450333275
551,swap,8231.0,411,13,13,1,26,0.36209797450333275
552,mut_micro,8231.0,411,13,13,1,26,0.36209797450333275
553,mut_micro,8231.0,411,13,13,1,26,0.36209797450333275
554,swap,8231.0,411,13,13,1,26,0.36209797450333275
555,swap,8231.0,411,13,13,1,26,0.36209797450333275
556,mut_micro,8231.0,411,13,13,1,26,0.36209797450333275
557,mut_micro,8231.0,411,13,13,1,26,0.36209797450333275
558,mut_micro,8231.0,411,13,13,1,26,0.36209797450333275
559,swap,8231.0,411,13,13,1,26,0.36209797450333275
560,swap,8231.0,411,13,13,1,26,0.36209797450333275
561,swap,8231.0,411,13,13,1,26,0.36209797450333275
562,reassign,8231.0,411,13,13,1,26,0.36209797450333275
563,swap,8231.0,411,13,13,1,26,0.36209797450333275
564,swap,8231.0,411,13,13,1,26,0.36209797450333275
565,swap,8231.0,411,13,13,1,26,0.36209797450333275
566,swap,8231.0,411,13,13,1,26,0.36209797450333275
567,swap,8231.0,411,13,13,1,26,0.36209797450333275
568,swap,8231.0,411,13,13,1,26,0.36209797450333275
569,swap,8231.0,411,13,13,1,26,0.36209797450333275
570,swap,8231.0,411,13,13,1,26,0.36209797450333275
571,swap,8231.0,411,13,13,1,26,0.36209797450333275
572,swap,8231.0,411,13,13,1,26,0.36209797450333275
573,swap,8231.0,411,13,13,1,26,0.36209797450333275
574,swap,8231.0,411,13,13,1,26,0.36209797450333275
575,swap,8231.0,411,13,13,1,26,0.36209797450333275
576,mut_micro,8231.0,411,13,13,1,26,0.36209797450333275
577,swap,8231.0,411,13,13,1,26,0.36209797450333275
578,swap,8231.0,411,13,13,1,26,0.36209797450333275
579,swap,8231.0,411,13,13,1,26,0.36209797450333275
580,swap,8231.0,411,13,13,1,26,0.36209797450333275
581,swap,8231.0,411,13,13,1,26,0.36209797450333275
582,swap,8231.0,411,13,13,1,26,0.36209797450333275
583,swap,8231.0,411,13,13,1,26,0.36209797450333275
584,swap,8231.0,411,13,13,1,26,0.36209797450333275
585,swap,8231.0,411,13,13,1,26,0.36209797450333275
586,swap,8231.0,411,13,13,1,26,0.36209797450333275
587,mut_micro,8231.0,411,13,13,1,26,0.36209797450333275
588,swap,8231.0,411,13,13,1,26,0.36209797450333275
589,swap,8231.0,411,13,13,1,26,0.36209797450333275
590,swap,8231.0,411,13,13,1,26,0.36209797450333275
591,swap,8228.0,408,13,13,1,26,0.36011790337049865
592,swap,8228.0,408,13,13,1,26,0.36011790337049865
593,swap,7936.0,416,13,12,1,25,0.36616660086853536
594,swap,7936.0,416,13,12,1,25,0.36616660086853536
595,swap,7936.0,416,13,12,1,25,0.36616660086853536
596,swap,7640.0,420,13,11,1,24,0.36961451247165544
597,mut_micro,7640.0,420,13,11,1,24,0.36961451247165544
598,swap,7640.0,420,13,11,1,24,0.36961451247165544
599,swap,7640.0,420,13,11,1,24,0.36961451247165544
600,swap,7640.0,420,13,11,1,24,0.36961451247165544
601,swap,7640.0,420,13,11,1,24,0.36961451247165544
602,swap,7640.0,420,13,11,1,24,0.36961451247165544
603,swap,7640.0,420,13,11,1,24,0.36961451247165544
604,swap,7640.0,420,13,11,1,24,0.36961451247165544
605,swap,7640.0,420,13,11,1,24,0.36961451247165544
606,mut_micro,7640.0,420,13,11,1,24,0.36961451247165544
607,swap,7640.0,420,13,11,1,24,0.36961451247165544
608,swap,7640.0,420,13,11,1,24,0.36961451247165544
609,swap,7640.0,420,13,11,1,24,0.36961451247165544
610,swap,7640.0,420,13,11,1,24,0.36961451247165544
611,swap,7640.0,420,13,11,1,24,0.36961451247165544
612,swap,7640.0,420,13,11,1,24,0.36961451247165544
613,swap,7640.0,420,13,11,1,24,0.36961451247165544
614,swap,7640.0,420,13,11,1,24,0.36961451247165544
615,swap,7640.0,420,13,11,1,24,0.36961451247165544
616,swap,7640.0,420,13,11,1,24,0.36961451247165544
617,swap,7640.0,420,13,11,1,24,0.36961451247165544
618,swap,7640.0,420,13,11,1,24,0.36961451247165544
619,swap,7640.0,420,13,11,1,24,0.36961451247165544
620,swap,7640.0,420,13,11,1,24,0.36961451247165544
621,swap,7640.0,420,13,11,1,24,0.36961451247165544
622,mut_micro,7640.0,420,13,11,1,24,0.36961451247165544
623,swap,7640.0,420,13,11,1,24,0.36961451247165544
624,swap,7640.0,420,13,11,1,24,0.36961451247165544
625,swap,7640.0,420,13,11,1,24,0.36961451247165544
626,swap,7640.0,420,13,11,1,24,0.36961451247165544
627,mut_micro,7638.0,418,13,11,1,24,0.3669183889772125
628,swap,7638.0,418,13,11,1,24,0.3669183889772125
629,swap,7638.0,418,13,11,1,24,0.3669183889772125
630,swap,7638.0,418,13,11,1,24,0.3669183889772125
631,swap,7638.0,418,13,11,1,24,0.3669183889772125
632,swap,7638.0,418,13,11,1,24,0.3669183889772125
633,swap,7638.0,418,13,11,1,24,0.3669183889772125
634,swap,7638.0,418,13,11,1,24,0.3669183889772125
635,swap,7638.0,418,13,11,1,24,0.3669183889772125
636,swap,7638.0,418,13,11,1,24,0.3669183889772125
637,swap,7638.0,418,13,11,1,24,0.3669183889772125
638,swap,7638.0,418,13,11,1,24,0.3669183889772125
639,swap,7638.0,418,13,11,1,24,0.3669183889772125
640,swap,7347.0,427,13,10,1,23,0.37210493953679047
641,swap,7347.0,427,13,10,1,23,0.37210493953679047
642,swap,7347.0,427,13,10,1,23,0.37210493953679047
643,swap,7347.0,427,13,10,1,23,0.37210493953679047
644,swap,7347.0,427,13,10,1,23,0.37210493953679047
645,swap,7347.0,427,13,10,1,23,0.37210493953679047
646,swap,7347.0,427,13,10,1,23,0.37210493953679047
647,reassign,7347.0,427,13,10,1,23,0.37210493953679047
648,swap,7347.0,427,13,10,1,23,0.37210493953679047
649,swap,7347.0,427,13,10,1,23,0.37210493953679047
650,swap,7347.0,427,13,10,1,23,0.37210493953679047
651,mut_micro,7049.0,429,12,10,1,22,0.37251461988304085
652,swap,7049.0,429,12,10,1,22,0.37251461988304085
653,swap,7049.0,429,12,10,1,22,0.37251461988304085
654,swap,7049.0,429,12,10,1,22,0.37251461988304085
655,swap,7049.0,429,12,10,1,22,0.37251461988304085
656,swap,7049.0,429,12,10,1,22,0.37251461988304085
657,swap,7049.0,429,12,10,1,22,0.37251461988304085
658,swap,7049.0,429,12,10,1,22,0.37251461988304085
659,swap,7049.0,429,12,10,1,22,0.37251461988304085
660,swap,7049.0,429,12,10,1,22,0.37251461988304085
661,reassign,7049.0,429,12,10,1,22,0.37251461988304085
662,swap,7049.0,429,12,10,1,22,0.37251461988304085
663,swap,7049.0,429,12,10,1,22,0.37251461988304085
664,swap,7049.0,429,12,10,1,22,0.37251461988304085
665,swap,7049.0,429,12,10,1,22,0.37251461988304085
666,swap,7049.0,429,12,10,1,22,0.37251461988304085
667,swap,7049.0,429,12,10,1,22,0.37251461988304085
668,swap,7049.0,429,12,10,1,22,0.37251461988304085
669,swap,7049.0,429,12,10,1,22,0.37251461988304085
670,swap,7049.0,429,12,10,1,22,0.37251461988304085
671,swap,7049.0,429,12,10,1,22,0.37251461988304085
672,swap,7049.0,429,12,10,1,22,0.37251461988304085
673,swap,7049.0,429,12,10,1,22,0.37251461988304085
674,swap,7049.0,429,12,10,1,22,0.37251461988304085
675,swap,7049.0,429,12,10,1,22,0.37251461988304085
676,swap,7049.0,429,12,10,1,22,0.37251461988304085
677,swap,7049.0,429,12,10,1,22,0.37251461988304085
678,swap,7049.0,429,12,10,1,22,0.37251461988304085
679,swap,7049.0,429,12,10,1,22,0.37251461988304085
680,swap,7049.0,429,12,10,1,22,0.37251461988304085
681,swap,7049.0,429,12,10,1,22,0.37251461988304085
682,swap,7049.0,429,12,10,1,22,0.37251461988304085
683,reassign,7049.0,429,12,10,1,22,0.37251461988304085
684,swap,7049.0,429,12,10,1,22,0.37251461988304085
685,swap,7049.0,429,12,10,1,22,0.37251461988304085
686,swap,7049.0,429,12,10,1,22,0.37251461988304085
687,swap,7049.0,429,12,10,1,22,0.37251461988304085
688,swap,7049.0,429,12,10,1,22,0.37251461988304085
689,reassign,7049.0,429,12,10,1,22,0.37251461988304085
690,swap,7049.0,429,12,10,1,22,0.37251461988304085
691,swap,7049.0,429,12,10,1,22,0.37251461988304085
692,swap,7049.0,429,12,10,1,22,0.37251461988304085
693,swap,7049.0,429,12,10,1,22,0.37251461988304085
694,swap,7049.0,429,12,10,1,22,0.37251461988304085
695,swap,7049.0,429,12,10,1,22,0.37251461988304085
696,swap,7049.0,429,12,10,1,22,0.37251461988304085
697,swap,7049.0,429,12,10,1,22,0.37251461988304085
698,swap,7049.0,429,12,10,1,22,0.37251461988304085
699,swap,7049.0,429,12,10,1,22,0.37251461988304085
700,mut_micro,6751.0,431,12,9,1,21,0.37279151943462907
701,mut_micro,6751.0,431,12,9,1,21,0.37279151943462907
702,mut_micro,6751.0,431,12,9,1,21,0.37279151943462907
703,mut_micro,6751.0,431,12,9,1,21,0.37279151943462907
704,swap,6751.0,431,12,9,1,21,0.37279151943462907
705,swap,6751.0,431,12,9,1,21,0.37279151943462907
706,swap,6751.0,431,12,9,1,21,0.37279151943462907
707,swap,6751.0,431,12,9,1,21,0.37279151943462907
708,mut_micro,6748.0,428,12,9,1,21,0.369600987248046
709,mut_micro,6748.0,428,12,9,1,21,0.369600987248046
710,mut_micro,6748.0,428,12,9,1,21,0.369600987248046
711,mut_micro,6748.0,428,12,9,1,21,0.369600987248046
712,mut_micro,6748.0,428,12,9,1,21,0.369600987248046
713,mut_micro,6748.0,428,12,9,1,21,0.369600987248046
714,mut_micro,6747.0,427,12,9,1,21,0.36786909885905583
715,mut_micro,6747.0,427,12,9,1,21,0.36786909885905583
716,mut_micro,6747.0,427,12,9,1,21,0.36786909885905583
717,mut_micro,6747.0,427,12,9,1,21,0.36786909885905583
718,mut_micro,6747.0,427,12,9,1,21,0.36786909885905583
719,reassign,6747.0,427,12,9,1,21,0.36786909885905583
720,mut_micro,6747.0,427,12,9,1,21,0.36786909885905583
721,mut_micro,6743.0,423,12,9,1,21,0.3647665251667677
722,mut_micro,6742.0,422,11,10,1,21,0.36496105291431635
723,mut_micro,6742.0,422,11,10,1,21,0.36496105291431635
724,mut_micro,6742.0,422,11,10,1,21,0.36496105291431635
725,mut_micro,6742.0,422,11,10,1,21,0.36496105291431635
726,swap,6742.0,422,11,10,1,21,0.36496105291431635
727,swap,6742.0,422,11,10,1,21,0.36496105291431635
728,mut_micro,6741.0,421,11,10,1,21,0.36314662383724833
729,mut_micro,6741.0,421,11,10,1,21,0.36314662383724833
730,swap,6741.0,421,11,10,1,21,0.36314662383724833
731,mut_micro,6741.0,421,11,10,1,21,0.36314662383724833
732,mut_micro,6741.0,421,11,10,1,21,0.36314662383724833
733,mut_micro,6741.0,421,11,10,1,21,0.36314662383724833
734,mut_micro,6741.0,421,11,10,1,21,0.36314662383724833
735,mut_micro,6741.0,421,11,10,1,21,0.36314662383724833
736,mut_micro,6741.0,421,11,10,1,21,0.36314662383724833
737,mut_micro,6741.0,421,11,10,1,21,0.36314662383724833
738,swap,6741.0,421,11,10,1,21,0.36314662383724833
739,swap,6741.0,421,11,10,1,21,0.36314662383724833
740,swap,6741.0,421,11,10,1,21,0.36314662383724833
741,swap,6741.0,421,11,10,1,21,0.36314662383724833
742,swap,6741.0,421,11,10,1,21,0.36314662383724833
743,swap,6740.0,420,11,10,1,21,0.3588101907429639
744,swap,6740.0,420,11,10,1,21,0.3588101907429639
745,swap,6740.0,420,11,10,1,21,0.3588101907429639
746,swap,6740.0,420,11,10,1,21,0.3588101907429639
747,swap,6740.0,420,11,10,1,21,0.3588101907429639
748,swap,6740.0,420,11,10,1,21,0.3588101907429639
749,swap,6740.0,420,11,10,1,21,0.3588101907429639
750,swap,6446.0,426,11,9,1,20,0.3649237472766885
751,swap,6446.0,426,11,9,1,20,0.3649237472766885
752,swap,6446.0,426,11,9,1,20,0.3649237472766885
753,swap,6446.0,426,11,9,1,20,0.3649237472766885
754,swap,6446.0,426,11,9,1,20,0.3649237472766885
755,swap,6446.0,426,11,9,1,20,0.3649237472766885
756,swap,6446.0,426,11,9,1,20,0.3649237472766885
757,swap,6446.0,426,11,9,1,20,0.3649237472766885
758,swap,6446.0,426,11,9,1,20,0.3649237472766885
759,swap,6446.0,426,11,9,1,20,0.3649237472766885
760,swap,6446.0,426,11,9,1,20,0.3649237472766885
761,swap,6446.0,426,11,9,1,20,0.3649237472766885
762,swap,6446.0,426,11,9,1,20,0.3649237472766885
763,swap,6446.0,426,11,9,1,20,0.3649237472766885
764,swap,6446.0,426,11,9,1,20,0.3649237472766885
765,swap,6446.0,426,11,9,1,20,0.3649237472766885
766,swap,6446.0,426,11,9,1,20,0.3649237472766885
767,swap,6446.0,426,11,9,1,20,0.3649237472766885
768,swap,6446.0,426,11,9,1,20,0.3649237472766885
769,swap,6446.0,426,11,9,1,20,0.3649237472766885
770,swap,6446.0,426,11,9,1,20,0.3649237472766885
771,swap,6446.0,426,11,9,1,20,0.3649237472766885
772,swap,6446.0,426,11,9,1,20,0.3649237472766885
773,swap,6446.0,426,11,9,1,20,0.3649237472766885
774,swap,6446.0,426,11,9,1,20,0.3649237472766885
775,swap,6446.0,426,11,9,1,20,0.3649237472766885
776,swap,6445.0,425,11,9,1,20,0.36634100006784737
777,swap,6445.0,425,11,9,1,20,0.36634100006784737
778,swap,6445.0,425,11,9,1,20,0.36634100006784737
779,swap,6445.0,425,11,9,1,20,0.36634100006784737
780,swap,6445.0,425,11,9,1,20,0.36634100006784737
781,swap,6445.0,425,11,9,1,20,0.36634100006784737
782,swap,6445.0,425,11,9,1,20,0.36634100006784737
783,swap,6445.0,425,11,9,1,20,0.36634100006784737
784,swap,6445.0,425,11,9,1,20,0.36634100006784737
785,swap,6445.0,425,11,9,1,20,0.36634100006784737
786,swap,6445.0,425,11,9,1,20,0.36634100006784737
787,mut_micro,6445.0,425,11,9,1,20,0.36634100006784737
788,swap,6445.0,425,11,9,1,20,0.36634100006784737
789,swap,6445.0,425,11,9,1,20,0.36634100006784737
790,mut_micro,6445.0,425,11,9,1,20,0.36634100006784737
791,swap,6445.0,425,11,9,1,20,0.36634100006784737
792,swap,6445.0,425,11,9,1,20,0.36634100006784737
793,swap,6445.0,425,11,9,1,20,0.36634100006784737
794,swap,6445.0,425,11,9,1,20,0.36634100006784737
795,swap,6445.0,425,11,9,1,20,0.36634100006784737
796,swap,6445.0,425,11,9,1,20,0.36634100006784737
797,swap,6445.0,425,11,9,1,20,0.36634100006784737
798,swap,6445.0,425,11,9,1,20,0.36634100006784737
799,swap,6445.0,425,11,9,1,20,0.36634100006784737
800,swap,6445.0,425,11,9,1,20,0.36634100006784737
801,swap,6445.0,425,11,9,1,20,0.36634100006784737
802,swap,6445.0,425,11,9,1,20,0.36634100006784737
803,swap,6445.0,425,11,9,1,20,0.36634100006784737
804,swap,6445.0,425,11,9,1,20,0.36634100006784737
805,swap,6445.0,425,11,9,1,20,0.36634100006784737
806,swap,6445.0,425,11,9,1,20,0.36634100006784737
807,reassign,6445.0,425,11,9,1,20,0.36634100006784737
808,mut_micro,6443.0,423,11,9,1,20,0.3678660467623475
809,swap,6443.0,423,11,9,1,20,0.3678660467623475
810,swap,6443.0,423,11,9,1,20,0.3678660467623475
811,swap,6443.0,423,11,9,1,20,0.3678660467623475
812,swap,6443.0,423,11,9,1,20,0.3678660467623475
813,swap,6443.0,423,11,9,1,20,0.3678660467623475
814,swap,6443.0,423,11,9,1,20,0.3678660467623475
815,swap,6443.0,423,11,9,1,20,0.3678660467623475
816,swap,6443.0,423,11,9,1,20,0.3678660467623475
817,swap,6443.0,423,11,9,1,20,0.3678660467623475
818,swap,6443.0,423,11,9,1,20,0.3678660467623475
819,swap,6443.0,423,11,9,1,20,0.3678660467623475
820,swap,6443.0,423,11,9,1,20,0.3678660467623475
821,swap,6443.0,423,11,9,1,20,0.3678660467623475
822,swap,6443.0,423,11,9,1,20,0.3678660467623475
823,swap,6443.0,423,11,9,1,20,0.3678660467623475
824,swap,6443.0,423,11,9,1,20,0.3678660467623475
825,mut_micro,6443.0,423,11,9,1,20,0.3678660467623475
826,swap,6443.0,423,11,9,1,20,0.3678660467623475
827,swap,6443.0,423,11,9,1,20,0.3678660467623475
828,swap,6443.0,423,11,9,1,20,0.3678660467623475
829,swap,6443.0,423,11,9,1,20,0.3678660467623475
830,swap,6443.0,423,11,9,1,20,0.3678660467623475
831,swap,6443.0,423,11,9,1,20,0.3678660467623475
832,swap,6438.0,418,11,9,1,20,0.36585850556438787
833,swap,6438.0,418,11,9,1,20,0.36585850556438787
834,swap,6438.0,418,11,9,1,20,0.36585850556438787
835,swap,6438.0,418,11,9,1,20,0.36585850556438787
836,swap,6438.0,418,11,9,1,20,0.36585850556438787
837,swap,6438.0,418,11,9,1,20,0.36585850556438787
838,swap,6438.0,418,11,9,1,20,0.36585850556438787
839,swap,6438.0,418,11,9,1,20,0.36585850556438787
840,swap,6438.0,418,11,9,1,20,0.36585850556438787
841,swap,6438.0,418,11,9,1,20,0.36585850556438787
842,swap,6438.0,418,11,9,1,20,0.36585850556438787
843,swap,6438.0,418,11,9,1,20,0.36585850556438787
844,swap,6438.0,418,11,9,1,20,0.36585850556438787
845,swap,6438.0,418,11,9,1,20,0.36585850556438787
846,swap,6438.0,418,11,9,1,20,0.36585850556438787
847,swap,6438.0,418,11,9,1,20,0.36585850556438787
848,swap,6438.0,418,11,9,1,20,0.36585850556438787
849,swap,6438.0,418,11,9,1,20,0.36585850556438787
850,swap,6438.0,418,11,9,1,20,0.36585850556438787
851,swap,6438.0,418,11,9,1,20,0.36585850556438787
852,mut_micro,6438.0,418,11,9,1,20,0.36585850556438787
853,swap,6438.0,418,11,9,1,20,0.36585850556438787
854,swap,6438.0,418,11,9,1,20,0.36585850556438787
855,swap,6438.0,418,11,9,1,20,0.36585850556438787
856,swap,6438.0,418,11,9,1,20,0.36585850556438787
857,swap,6438.0,418,11,9,1,20,0.36585850556438787
858,reassign,6438.0,418,11,9,1,20,0.36585850556438787
859,swap,6438.0,418,11,9,1,20,0.36585850556438787
860,swap,6438.0,418,11,9,1,20,0.36585850556438787
861,swap,6438.0,418,11,9,1,20,0.36585850556438787
862,swap,6438.0,418,11,9,1,20,0.36585850556438787
863,swap,6141.0,421,11,8,1,19,0.3692364317740749
864,swap,6141.0,421,11,8,1,19,0.3692364317740749
865,swap,6141.0,421,11,8,1,19,0.3692364317740749
866,swap,6140.0,420,11,8,1,19,0.36868080565559563
867,swap,6140.0,420,11,8,1,19,0.36868080565559563
868,swap,6140.0,420,11,8,1,19,0.36868080565559563
869,swap,6140.0,420,11,8,1,19,0.36868080565559563
870,swap,6140.0,420,11,8,1,19,0.36868080565559563
871,swap,6140.0,420,11,8,1,19,0.36868080565559563
872,swap,6140.0,420,11,8,1,19,0.36868080565559563
873,swap,6140.0,420,11,8,1,19,0.36868080565559563
874,swap,6140.0,420,11,8,1,19,0.36868080565559563
875,swap,6140.0,420,11,8,1,19,0.36868080565559563
876,swap,6140.0,420,11,8,1,19,0.36868080565559563
877,swap,6140.0,420,11,8,1,19,0.36868080565559563
878,swap,6140.0,420,11,8,1,19,0.36868080565559563
879,swap,6140.0,420,11,8,1,19,0.36868080565559563
880,swap,6140.0,420,11,8,1,19,0.36868080565559563
881,swap,6140.0,420,11,8,1,19,0.36868080565559563
882,swap,6140.0,420,11,8,1,19,0.36868080565559563
883,swap,6140.0,420,11,8,1,19,0.36868080565559563
884,swap,6140.0,420,11,8,1,19,0.36868080565559563
885,swap,6140.0,420,11,8,1,19,0.36868080565559563
886,swap,6140.0,420,11,8,1,19,0.36868080565559563
887,swap,6140.0,420,11,8,1,19,0.36868080565559563
888,swap,6140.0,420,11,8,1,19,0.36868080565559563
889,swap,6140.0,420,11,8,1,19,0.36868080565559563
890,swap,6140.0,420,11,8,1,19,0.36868080565559563
891,swap,6140.0,420,11,8,1,19,0.36868080565559563
892,swap,6140.0,420,11,8,1,19,0.36868080565559563
893,swap,6140.0,420,11,8,1,19,0.36868080565559563
894,swap,6140.0,420,11,8,1,19,0.36868080565559563
895,swap,6140.0,420,11,8,1,19,0.36868080565559563
896,swap,6140.0,420,11,8,1,19,0.36868080565559563
897,swap,6140.0,420,11,8,1,19,0.36868080565559563
898,swap,6140.0,420,11,8,1,19,0.36868080565559563
899,swap,6140.0,420,11,8,1,19,0.36868080565559563
900,swap,6140.0,420,11,8,1,19,0.36868080565559563
901,swap,6140.0,420,11,8,1,19,0.36868080565559563
902,swap,6140.0,420,11,8,1,19,0.36868080565559563
903,swap,6140.0,420,11,8,1,19,0.36868080565559563
904,mut_micro,6136.0,416,11,8,1,19,0.3682721410711936
905,swap,6136.0,416,11,8,1,19,0.3682721410711936
906,swap,6136.0,416,11,8,1,19,0.3682721410711936
907,swap,6136.0,416,11,8,1,19,0.3682721410711936
908,swap,6136.0,416,11,8,1,19,0.3682721410711936
909,swap,6136.0,416,11,8,1,19,0.3682721410711936
910,swap,6136.0,416,11,8,1,19,0.3682721410711936
911,swap,6136.0,416,11,8,1,19,0.3682721410711936
912,swap,6136.0,416,11,8,1,19,0.3682721410711936
913,swap,6136.0,416,11,8,1,19,0.3682721410711936
914,swap,6136.0,416,11,8,1,19,0.3682721410711936
915,swap,6136.0,416,11,8,1,19,0.3682721410711936
916,swap,6136.0,416,11,8,1,19,0.3682721410711936
917,swap,6136.0,416,11,8,1,19,0.3682721410711936
918,swap,6136.0,416,11,8,1,19,0.3682721410711936
919,swap,6136.0,416,11,8,1,19,0.3682721410711936
920,swap,6136.0,416,11,8,1,19,0.3682721410711936
921,swap,6136.0,416,11,8,1,19,0.3682721410711936
922,reassign,6136.0,416,11,8,1,19,0.3682721410711936
923,swap,6136.0,416,11,8,1,19,0.3682721410711936
924,swap,6136.0,416,11,8,1,19,0.3682721410711936
925,swap,6136.0,416,11,8,1,19,0.3682721410711936
926,swap,6136.0,416,11,8,1,19,0.3682721410711936
927,swap,6136.0,416,11,8,1,19,0.3682721410711936
928,mut_micro,6136.0,416,11,8,1,19,0.3682721410711936
929,swap,6136.0,416,11,8,1,19,0.3682721410711936
930,swap,6136.0,416,11,8,1,19,0.3682721410711936
931,swap,6136.0,416,11,8,1,19,0.3682721410711936
932,swap,6136.0,416,11,8,1,19,0.3682721410711936
933,swap,6136.0,416,11,8,1,19,0.3682721410711936
934,swap,6136.0,416,11,8,1,19,0.3682721410711936
935,swap,6136.0,416,11,8,1,19,0.3682721410711936
936,swap,6136.0,416,11,8,1,19,0.3682721410711936
937,swap,6136.0,416,11,8,1,19,0.3682721410711936
938,swap,6136.0,416,11,8,1,19,0.3682721410711936
939,swap,6136.0,416,11,8,1,19,0.3682721410711936
940,swap,6136.0,416,11,8,1,19,0.3682721410711936
941,swap,6136.0,416,11,8,1,19,0.3682721410711936
942,swap,6136.0,416,11,8,1,19,0.3682721410711936
943,swap,6136.0,416,11,8,1,19,0.3682721410711936
944,swap,6136.0,416,11,8,1,19,0.3682721410711936
945,swap,6136.0,416,11,8,1,19,0.3682721410711936
946,swap,6136.0,416,11,8,1,19,0.3682721410711936
947,swap,6136.0,416,11,8,1,19,0.3682721410711936
948,swap,6136.0,416,11,8,1,19,0.3682721410711936
949,swap,6136.0,416,11,8,1,19,0.3682721410711936
950,swap,6136.0,416,11,8,1,19,0.3682721410711936
951,swap,6136.0,416,11,8,1,19,0.3682721410711936
952,swap,6136.0,416,11,8,1,19,0.3682721410711936
953,reassign,6136.0,416,11,8,1,19,0.3682721410711936
954,swap,6136.0,416,11,8,1,19,0.3682721410711936
955,swap,6136.0,416,11,8,1,19,0.3682721410711936
956,swap,6136.0,416,11,8,1,19,0.3682721410711936
957,swap,6136.0,416,11,8,1,19,0.3682721410711936
958,swap,6136.0,416,11,8,1,19,0.3682721410711936
959,swap,6136.0,416,11,8,1,19,0.3682721410711936
960,swap,6136.0,416,11,8,1,19,0.3682721410711936
961,swap,6136.0,416,11,8,1,19,0.3682721410711936
962,swap,6136.0,416,11,8,1,19,0.3682721410711936
963,swap,6136.0,416,11,8,1,19,0.3682721410711936
964,swap,6136.0,416,11,8,1,19,0.3682721410711936
965,swap,6136.0,416,11,8,1,19,0.3682721410711936
966,swap,6136.0,416,11,8,1,19,0.3682721410711936
967,swap,6136.0,416,11,8,1,19,0.3682721410711936
968,swap,6136.0,416,11,8,1,19,0.3682721410711936
969,swap,6136.0,416,11,8,1,19,0.3682721410711936
970,swap,6136.0,416,11,8,1,19,0.3682721410711936
971,swap,6136.0,416,11,8,1,19,0.3682721410711936
972,swap,6136.0,416,11,8,1,19,0.3682721410711936
973,swap,6136.0,416,11,8,1,19,0.3682721410711936
974,swap,6136.0,416,11,8,1,19,0.3682721410711936
975,swap,6136.0,416,11,8,1,19,0.3682721410711936
976,swap,6136.0,416,11,8,1,19,0.3682721410711936
977,swap,6136.0,416,11,8,1,19,0.3682721410711936
978,swap,6136.0,416,11,8,1,19,0.3682721410711936
979,swap,6136.0,416,11,8,1,19,0.3682721410711936
980,swap,6136.0,416,11,8,1,19,0.3682721410711936
981,swap,6136.0,416,11,8,1,19,0.3682721410711936
982,swap,6136.0,416,11,8,1,19,0.3682721410711936
983,swap,6136.0,416,11,8,1,19,0.3682721410711936
984,swap,6136.0,416,11,8,1,19,0.3682721410711936
985,swap,6136.0,416,11,8,1,19,0.3682721410711936
986,swap,6136.0,416,11,8,1,19,0.3682721410711936
987,mut_micro,6136.0,416,11,8,1,19,0.3682721410711936
988,swap,6136.0,416,11,8,1,19,0.3682721410711936
989,swap,6136.0,416,11,8,1,19,0.3682721410711936
990,swap,6136.0,416,11,8,1,19,0.3682721410711936
991,swap,6136.0,416,11,8,1,19,0.3682721410711936
992,swap,6136.0,416,11,8,1,19,0.3682721410711936
993,swap,6136.0,416,11,8,1,19,0.3682721410711936
994,swap,6136.0,416,11,8,1,19,0.3682721410711936
995,swap,6136.0,416,11,8,1,19,0.3682721410711936
996,swap,6136.0,416,11,8,1,19,0.3682721410711936
997,swap,6136.0,416,11,8,1,19,0.3682721410711936
998,swap,6136.0,416,11,8,1,19,0.3682721410711936
999,swap,6136.0,416,11,8,1,19,0.3682721410711936
1000,swap,6136.0,416,11,8,1,19,0.3682721410711936
