iter,op,fitness_score,pref_penalty,capacity_viol,elig_viol,under_cap,total_violations,gini
1,mut_micro,28141.0,321,37,55,11,92,0.25652347452976093
2,swap,27844.0,324,37,54,11,91,0.2632981397687281
3,swap,27546.0,326,37,53,11,90,0.26748534465332524
4,swap,27546.0,326,37,53,11,90,0.26748534465332524
5,swap,27546.0,326,37,53,11,90,0.26748534465332524
6,swap,27546.0,326,37,53,11,90,0.26748534465332524
7,swap,27546.0,326,37,53,11,90,0.26748534465332524
8,reassign,27242.0,322,36,53,11,89,0.2648559423769505
9,reassign,27242.0,322,36,53,11,89,0.2648559423769505
10,reassign,27242.0,322,36,53,11,89,0.2648559423769505
11,reassign,27242.0,322,36,53,11,89,0.2648559423769505
12,swap,27242.0,322,36,53,11,89,0.2648559423769505
13,swap,26945.0,325,36,52,11,88,0.2713594435203386
14,swap,26945.0,325,36,52,11,88,0.2713594435203386
15,swap,26945.0,325,36,52,11,88,0.2713594435203386
16,swap,26945.0,325,36,52,11,88,0.2713594435203386
17,swap,26945.0,325,36,52,11,88,0.2713594435203386
18,swap,26945.0,325,36,52,11,88,0.2713594435203386
19,reassign,26322.0,322,34,52,10,86,0.27025810324129634
20,reassign,26322.0,322,34,52,10,86,0.27025810324129634
21,reassign,26021.0,321,33,52,10,85,0.2707927954896971
22,reassign,25399.0,319,31,52,9,83,0.26674112683047885
23,reassign,25399.0,319,31,52,9,83,0.26674112683047885
24,reassign,25399.0,319,31,52,9,83,0.26674112683047885
25,swap,25399.0,319,31,52,9,83,0.26674112683047885
26,swap,25104.0,324,31,51,9,82,0.27481146304675724
27,swap,25104.0,324,31,51,9,82,0.27481146304675724
28,swap,25104.0,324,31,51,9,82,0.27481146304675724
29,swap,25104.0,324,31,51,9,82,0.27481146304675724
30,swap,25104.0,324,31,51,9,82,0.27481146304675724
31,swap,25104.0,324,31,51,9,82,0.27481146304675724
32,swap,25104.0,324,31,51,9,82,0.27481146304675724
33,reassign,24485.0,325,30,50,8,80,0.2742829779726799
34,reassign,24485.0,325,30,50,8,80,0.2742829779726799
35,swap,24485.0,325,30,50,8,80,0.2742829779726799
36,swap,24485.0,325,30,50,8,80,0.2742829779726799
37,reassign,23889.0,329,29,49,8,78,0.27703081232492993
38,reassign,23889.0,329,29,49,8,78,0.27703081232492993
39,reassign,23889.0,329,29,49,8,78,0.27703081232492993
40,swap,23889.0,329,29,49,8,78,0.27703081232492993
41,swap,23889.0,329,29,49,8,78,0.27703081232492993
42,swap,23889.0,329,29,49,8,78,0.27703081232492993
43,swap,23889.0,329,29,49,8,78,0.27703081232492993
44,swap,23889.0,329,29,49,8,78,0.27703081232492993
45,swap,23593.0,333,29,48,8,77,0.28261540836807175
46,swap,23593.0,333,29,48,8,77,0.28261540836807175
47,swap,23593.0,333,29,48,8,77,0.28261540836807175
48,swap,23593.0,333,29,48,8,77,0.28261540836807175
49,swap,23299.0,339,29,47,8,76,0.28682352941176487
50,swap,23007.0,347,29,46,8,75,0.2975637121333547
51,swap,23007.0,347,29,46,8,75,0.2975637121333547
52,mut_micro,23007.0,347,29,46,8,75,0.2975637121333547
53,swap,23007.0,347,29,46,8,75,0.2975637121333547
54,swap,23007.0,347,29,46,8,75,0.2975637121333547
55,reassign,22385.0,345,27,46,7,73,0.2961634518305967
56,reassign,22385.0,345,27,46,7,73,0.2961634518305967
57,swap,22385.0,345,27,46,7,73,0.2961634518305967
58,swap,22385.0,345,27,46,7,73,0.2961634518305967
59,swap,22385.0,345,27,46,7,73,0.2961634518305967
60,swap,22385.0,345,27,46,7,73,0.2961634518305967
61,swap,22385.0,345,27,46,7,73,0.2961634518305967
62,swap,22385.0,345,27,46,7,73,0.2961634518305967
63,swap,22385.0,345,27,46,7,73,0.2961634518305967
64,swap,22385.0,345,27,46,7,73,0.2961634518305967
65,swap,22385.0,345,27,46,7,73,0.2961634518305967
66,swap,22385.0,345,27,46,7,73,0.2961634518305967
67,swap,22088.0,348,27,45,7,72,0.30043930140362163
68,swap,22088.0,348,27,45,7,72,0.30043930140362163
69,swap,22088.0,348,27,45,7,72,0.30043930140362163
70,swap,21794.0,354,27,44,7,71,0.3052832244008713
71,swap,21497.0,357,27,43,7,70,0.3100730488273741
72,swap,21497.0,357,27,43,7,70,0.3100730488273741
73,swap,21497.0,357,27,43,7,70,0.3100730488273741
74,swap,21497.0,357,27,43,7,70,0.3100730488273741
75,swap,21497.0,357,27,43,7,70,0.3100730488273741
76,swap,21497.0,357,27,43,7,70,0.3100730488273741
77,swap,21497.0,357,27,43,7,70,0.3100730488273741
78,swap,21497.0,357,27,43,7,70,0.3100730488273741
79,reassign,21497.0,357,27,43,7,70,0.3100730488273741
80,reassign,21480.0,360,26,44,6,70,0.3147778885565527
81,swap,21185.0,365,26,43,6,69,0.3219001067475702
82,swap,21185.0,365,26,43,6,69,0.3219001067475702
83,swap,21185.0,365,26,43,6,69,0.3219001067475702
84,swap,21185.0,365,26,43,6,69,0.3219001067475702
85,swap,21185.0,365,26,43,6,69,0.3219001067475702
86,swap,20884.0,364,26,42,6,68,0.3203921568627452
87,swap,20884.0,364,26,42,6,68,0.3203921568627452
88,swap,20884.0,364,26,42,6,68,0.3203921568627452
89,swap,20884.0,364,26,42,6,68,0.3203921568627452
90,swap,20589.0,369,26,41,6,67,0.32449559533958505
91,swap,20589.0,369,26,41,6,67,0.32449559533958505
92,mut_micro,20589.0,369,26,41,6,67,0.32449559533958505
93,swap,20589.0,369,26,41,6,67,0.32449559533958505
94,swap,20589.0,369,26,41,6,67,0.32449559533958505
95,swap,20589.0,369,26,41,6,67,0.32449559533958505
96,swap,20589.0,369,26,41,6,67,0.32449559533958505
97,swap,20589.0,369,26,41,6,67,0.32449559533958505
98,swap,20589.0,369,26,41,6,67,0.32449559533958505
99,swap,20589.0,369,26,41,6,67,0.32449559533958505
100,swap,20589.0,369,26,41,6,67,0.32449559533958505
101,swap,20589.0,369,26,41,6,67,0.32449559533958505
102,swap,20587.0,367,26,41,6,67,0.3233033847544781
103,swap,20587.0,367,26,41,6,67,0.3233033847544781
104,swap,20587.0,367,26,41,6,67,0.3233033847544781
105,swap,20587.0,367,26,41,6,67,0.3233033847544781
106,swap,20587.0,367,26,41,6,67,0.3233033847544781
107,swap,20587.0,367,26,41,6,67,0.3233033847544781
108,swap,20294.0,374,26,40,6,66,0.33085351787773937
109,swap,20294.0,374,26,40,6,66,0.33085351787773937
110,swap,19999.0,379,26,39,6,65,0.3375182908984491
111,mut_micro,19701.0,381,25,39,6,64,0.3397809574280162
112,swap,19701.0,381,25,39,6,64,0.3397809574280162
113,swap,19701.0,381,25,39,6,64,0.3397809574280162
114,mut_micro,19684.0,384,24,40,5,64,0.33998811645870464
115,swap,19684.0,384,24,40,5,64,0.33998811645870464
116,reassign,19362.0,382,22,41,4,63,0.3365225608315616
117,swap,19362.0,382,22,41,4,63,0.3365225608315616
118,swap,19362.0,382,22,41,4,63,0.3365225608315616
119,swap,19362.0,382,22,41,4,63,0.3365225608315616
120,reassign,19362.0,382,22,41,4,63,0.3365225608315616
121,swap,19362.0,382,22,41,4,63,0.3365225608315616
122,reassign,19065.0,385,22,40,4,62,0.336521842779665
123,swap,18470.0,390,22,38,4,60,0.34289518276446374
124,swap,18470.0,390,22,38,4,60,0.34289518276446374
125,swap,18470.0,390,22,38,4,60,0.34289518276446374
126,swap,18470.0,390,22,38,4,60,0.34289518276446374
127,swap,18470.0,390,22,38,4,60,0.34289518276446374
128,swap,18470.0,390,22,38,4,60,0.34289518276446374
129,swap,18470.0,390,22,38,4,60,0.34289518276446374
130,swap,18470.0,390,22,38,4,60,0.34289518276446374
131,reassign,18468.0,388,22,38,4,60,0.33940815590039697
132,reassign,18468.0,388,22,38,4,60,0.33940815590039697
133,swap,18468.0,388,22,38,4,60,0.33940815590039697
134,swap,18468.0,388,22,38,4,60,0.33940815590039697
135,mut_micro,18468.0,388,22,38,4,60,0.33940815590039697
136,swap,18468.0,388,22,38,4,60,0.33940815590039697
137,swap,18468.0,388,22,38,4,60,0.33940815590039697
138,swap,18468.0,388,22,38,4,60,0.33940815590039697
139,swap,18468.0,388,22,38,4,60,0.33940815590039697
140,swap,18468.0,388,22,38,4,60,0.33940815590039697
141,reassign,18468.0,388,22,38,4,60,0.33940815590039697
142,mut_micro,18185.0,385,21,38,5,59,0.33515108170927943
143,swap,18185.0,385,21,38,5,59,0.33515108170927943
144,swap,18184.0,384,21,38,5,59,0.3344028520499109
145,swap,17893.0,393,21,37,5,58,0.3419766660558306
146,swap,17893.0,393,21,37,5,58,0.3419766660558306
147,swap,17603.0,403,21,36,5,57,0.3478027867095391
148,swap,17603.0,403,21,36,5,57,0.3478027867095391
149,swap,17601.0,401,21,36,5,57,0.344390152227025
150,swap,17601.0,401,21,36,5,57,0.344390152227025
151,swap,17601.0,401,21,36,5,57,0.344390152227025
152,reassign,17601.0,401,21,36,5,57,0.344390152227025
153,swap,17601.0,401,21,36,5,57,0.344390152227025
154,swap,17601.0,401,21,36,5,57,0.344390152227025
155,swap,17601.0,401,21,36,5,57,0.344390152227025
156,swap,17601.0,401,21,36,5,57,0.344390152227025
157,swap,17301.0,401,21,35,5,56,0.344390152227025
158,swap,17301.0,401,21,35,5,56,0.344390152227025
159,swap,17301.0,401,21,35,5,56,0.344390152227025
160,swap,17002.0,402,21,34,5,55,0.3449597787833083
161,swap,17002.0,402,21,34,5,55,0.3449597787833083
162,swap,17002.0,402,21,34,5,55,0.3449597787833083
163,swap,17002.0,402,21,34,5,55,0.3449597787833083
164,swap,17002.0,402,21,34,5,55,0.3449597787833083
165,swap,17002.0,402,21,34,5,55,0.3449597787833083
166,swap,17002.0,402,21,34,5,55,0.3449597787833083
167,swap,17002.0,402,21,34,5,55,0.3449597787833083
168,swap,17002.0,402,21,34,5,55,0.3449597787833083
169,swap,17002.0,402,21,34,5,55,0.3449597787833083
170,swap,17002.0,402,21,34,5,55,0.3449597787833083
171,swap,17002.0,402,21,34,5,55,0.3449597787833083
172,reassign,16677.0,397,21,33,4,54,0.34214758458588496
173,swap,16677.0,397,21,33,4,54,0.34214758458588496
174,swap,16675.0,395,21,33,4,54,0.338588727026861
175,swap,16383.0,403,21,32,4,53,0.34547002080574996
176,swap,16383.0,403,21,32,4,53,0.34547002080574996
177,swap,16383.0,403,21,32,4,53,0.34547002080574996
178,swap,16383.0,403,21,32,4,53,0.34547002080574996
179,swap,16383.0,403,21,32,4,53,0.34547002080574996
180,swap,16383.0,403,21,32,4,53,0.34547002080574996
181,reassign,16383.0,403,21,32,4,53,0.34547002080574996
182,swap,16383.0,403,21,32,4,53,0.34547002080574996
183,swap,16383.0,403,21,32,4,53,0.34547002080574996
184,mut_micro,16383.0,403,21,32,4,53,0.34547002080574996
185,mut_micro,16365.0,405,21,32,3,53,0.3440890919474586
186,mut_micro,16062.0,402,20,32,3,52,0.3449597787833083
187,mut_micro,16062.0,402,20,32,3,52,0.3449597787833083
188,mut_micro,16062.0,402,20,32,3,52,0.3449597787833083
189,swap,16062.0,402,20,32,3,52,0.3449597787833083
190,swap,16062.0,402,20,32,3,52,0.3449597787833083
191,swap,16062.0,402,20,32,3,52,0.3449597787833083
192,swap,16062.0,402,20,32,3,52,0.3449597787833083
193,swap,16062.0,402,20,32,3,52,0.3449597787833083
194,swap,15768.0,408,20,31,3,51,0.34954504677688064
195,swap,15768.0,408,20,31,3,51,0.34954504677688064
196,swap,15768.0,408,20,31,3,51,0.34954504677688064
197,swap,15768.0,408,20,31,3,51,0.34954504677688064
198,swap,15768.0,408,20,31,3,51,0.34954504677688064
199,swap,15768.0,408,20,31,3,51,0.34954504677688064
200,reassign,15163.0,403,19,30,3,49,0.3469831662568565
201,swap,15163.0,403,19,30,3,49,0.3469831662568565
202,swap,15163.0,403,19,30,3,49,0.3469831662568565
203,swap,15163.0,403,19,30,3,49,0.3469831662568565
204,swap,15163.0,403,19,30,3,49,0.3469831662568565
205,mut_micro,15163.0,403,19,30,3,49,0.3469831662568565
206,swap,15163.0,403,19,30,3,49,0.3469831662568565
207,swap,15163.0,403,19,30,3,49,0.3469831662568565
208,reassign,15162.0,402,18,31,3,49,0.34640522875816987
209,reassign,15162.0,402,18,31,3,49,0.34640522875816987
210,swap,15162.0,402,18,31,3,49,0.34640522875816987
211,swap,15162.0,402,18,31,3,49,0.34640522875816987
212,swap,15162.0,402,18,31,3,49,0.34640522875816987
213,swap,14866.0,406,18,30,3,48,0.35306850012732366
214,swap,14866.0,406,18,30,3,48,0.35306850012732366
215,swap,14863.0,403,18,30,3,48,0.35360317760544735
216,swap,14863.0,403,18,30,3,48,0.35360317760544735
217,swap,14863.0,403,18,30,3,48,0.35360317760544735
218,swap,14863.0,403,18,30,3,48,0.35360317760544735
219,swap,14863.0,403,18,30,3,48,0.35360317760544735
220,swap,14863.0,403,18,30,3,48,0.35360317760544735
221,swap,14863.0,403,18,30,3,48,0.35360317760544735
222,reassign,14863.0,403,18,30,3,48,0.35360317760544735
223,swap,14863.0,403,18,30,3,48,0.35360317760544735
224,reassign,14858.0,398,19,29,3,48,0.35070737155621745
225,reassign,14858.0,398,19,29,3,48,0.35070737155621745
226,swap,14858.0,398,19,29,3,48,0.35070737155621745
227,swap,14858.0,398,19,29,3,48,0.35070737155621745
228,swap,14858.0,398,19,29,3,48,0.35070737155621745
229,swap,14858.0,398,19,29,3,48,0.35070737155621745
230,swap,14858.0,398,19,29,3,48,0.35070737155621745
231,swap,14858.0,398,19,29,3,48,0.35070737155621745
232,swap,14858.0,398,19,29,3,48,0.35070737155621745
233,swap,14858.0,398,19,29,3,48,0.35070737155621745
234,swap,14858.0,398,19,29,3,48,0.35070737155621745
235,swap,14858.0,398,19,29,3,48,0.35070737155621745
236,swap,14858.0,398,19,29,3,48,0.35070737155621745
237,swap,14858.0,398,19,29,3,48,0.35070737155621745
238,swap,14858.0,398,19,29,3,48,0.35070737155621745
239,reassign,14857.0,397,19,29,3,48,0.349941238324983
240,reassign,14854.0,394,19,29,3,48,0.34583333333333327
241,reassign,14854.0,394,19,29,3,48,0.34583333333333327
242,reassign,14854.0,394,19,29,3,48,0.34583333333333327
243,swap,14854.0,394,19,29,3,48,0.34583333333333327
244,swap,14854.0,394,19,29,3,48,0.34583333333333327
245,swap,14854.0,394,19,29,3,48,0.34583333333333327
246,reassign,13950.0,390,17,28,3,45,0.34452916969256836
247,reassign,13950.0,390,17,28,3,45,0.34452916969256836
248,reassign,13653.0,393,16,28,3,44,0.34869586463869046
249,reassign,13653.0,393,16,28,3,44,0.34869586463869046
250,reassign,13653.0,393,16,28,3,44,0.34869586463869046
251,reassign,13653.0,393,16,28,3,44,0.34869586463869046
252,reassign,13653.0,393,16,28,3,44,0.34869586463869046
253,reassign,13653.0,393,16,28,3,44,0.34869586463869046
254,reassign,13653.0,393,16,28,3,44,0.34869586463869046
255,reassign,13653.0,393,16,28,3,44,0.34869586463869046
256,swap,13653.0,393,16,28,3,44,0.34869586463869046
257,swap,13653.0,393,16,28,3,44,0.34869586463869046
258,swap,13653.0,393,16,28,3,44,0.34869586463869046
259,swap,13653.0,393,16,28,3,44,0.34869586463869046
260,swap,13653.0,393,16,28,3,44,0.34869586463869046
261,swap,13653.0,393,16,28,3,44,0.34869586463869046
262,swap,13653.0,393,16,28,3,44,0.34869586463869046
263,reassign,13653.0,393,16,28,3,44,0.34869586463869046
264,reassign,13653.0,393,16,28,3,44,0.34869586463869046
265,reassign,13653.0,393,16,28,3,44,0.34869586463869046
266,swap,13653.0,393,16,28,3,44,0.34869586463869046
267,reassign,13653.0,393,16,28,3,44,0.34869586463869046
268,swap,13653.0,393,16,28,3,44,0.34869586463869046
269,swap,13653.0,393,16,28,3,44,0.34869586463869046
270,swap,13653.0,393,16,28,3,44,0.34869586463869046
271,swap,13653.0,393,16,28,3,44,0.34869586463869046
272,swap,13653.0,393,16,28,3,44,0.34869586463869046
273,swap,13653.0,393,16,28,3,44,0.34869586463869046
274,swap,13653.0,393,16,28,3,44,0.34869586463869046
275,swap,13653.0,393,16,28,3,44,0.34869586463869046
276,swap,13653.0,393,16,28,3,44,0.34869586463869046
277,swap,13653.0,393,16,28,3,44,0.34869586463869046
278,swap,13653.0,393,16,28,3,44,0.34869586463869046
279,swap,13653.0,393,16,28,3,44,0.34869586463869046
280,mut_micro,13652.0,392,16,28,3,44,0.3472780416514432
281,swap,13652.0,392,16,28,3,44,0.3472780416514432
282,swap,13651.0,391,16,28,3,44,0.3447155952164148
283,swap,13651.0,391,16,28,3,44,0.3447155952164148
284,swap,13651.0,391,16,28,3,44,0.3447155952164148
285,swap,13651.0,391,16,28,3,44,0.3447155952164148
286,reassign,13651.0,391,16,28,3,44,0.3447155952164148
287,reassign,13353.0,393,15,28,3,43,0.348085028403885
288,reassign,13353.0,393,15,28,3,43,0.348085028403885
289,reassign,13353.0,393,15,28,3,43,0.348085028403885
290,reassign,13353.0,393,15,28,3,43,0.348085028403885
291,swap,13353.0,393,15,28,3,43,0.348085028403885
292,swap,13353.0,393,15,28,3,43,0.348085028403885
293,swap,13353.0,393,15,28,3,43,0.348085028403885
294,reassign,13335.0,395,15,28,2,43,0.34713258344089987
295,swap,13335.0,395,15,28,2,43,0.34713258344089987
296,swap,13335.0,395,15,28,2,43,0.34713258344089987
297,swap,13335.0,395,15,28,2,43,0.34713258344089987
298,swap,13335.0,395,15,28,2,43,0.34713258344089987
299,swap,13335.0,395,15,28,2,43,0.34713258344089987
300,swap,13334.0,394,15,28,2,43,0.34522058823529417
301,swap,13334.0,394,15,28,2,43,0.34522058823529417
302,swap,13334.0,394,15,28,2,43,0.34522058823529417
303,swap,13040.0,400,15,27,2,42,0.3501311352566504
304,swap,13040.0,400,15,27,2,42,0.3501311352566504
305,reassign,13040.0,400,15,27,2,42,0.3501311352566504
306,swap,13040.0,400,15,27,2,42,0.3501311352566504
307,swap,13040.0,400,15,27,2,42,0.3501311352566504
308,swap,13040.0,400,15,27,2,42,0.3501311352566504
309,swap,13040.0,400,15,27,2,42,0.3501311352566504
310,swap,13040.0,400,15,27,2,42,0.3501311352566504
311,swap,12740.0,400,15,26,2,41,0.3501311352566504
312,swap,12740.0,400,15,26,2,41,0.3501311352566504
313,swap,12740.0,400,15,26,2,41,0.3501311352566504
314,swap,12740.0,400,15,26,2,41,0.3501311352566504
315,swap,12740.0,400,15,26,2,41,0.3501311352566504
316,swap,12740.0,400,15,26,2,41,0.3501311352566504
317,swap,12740.0,400,15,26,2,41,0.3501311352566504
318,swap,12740.0,400,15,26,2,41,0.3501311352566504
319,swap,12740.0,400,15,26,2,41,0.3501311352566504
320,swap,12740.0,400,15,26,2,41,0.3501311352566504
321,swap,12740.0,400,15,26,2,41,0.3501311352566504
322,swap,12740.0,400,15,26,2,41,0.3501311352566504
323,swap,12740.0,400,15,26,2,41,0.3501311352566504
324,swap,12740.0,400,15,26,2,41,0.3501311352566504
325,swap,12740.0,400,15,26,2,41,0.3501311352566504
326,swap,12740.0,400,15,26,2,41,0.3501311352566504
327,swap,12740.0,400,15,26,2,41,0.3501311352566504
328,reassign,12740.0,400,15,26,2,41,0.3501311352566504
329,swap,12739.0,399,15,26,2,41,0.34973544973544973
330,swap,12739.0,399,15,26,2,41,0.34973544973544973
331,swap,12438.0,398,15,25,2,40,0.3507694216927278
332,swap,12438.0,398,15,25,2,40,0.3507694216927278
333,mut_micro,12437.0,397,16,24,2,40,0.34895156800890703
334,swap,12437.0,397,16,24,2,40,0.34895156800890703
335,swap,12437.0,397,16,24,2,40,0.34895156800890703
336,swap,12437.0,397,16,24,2,40,0.34895156800890703
337,swap,12437.0,397,16,24,2,40,0.34895156800890703
338,swap,12437.0,397,16,24,2,40,0.34895156800890703
339,swap,12437.0,397,16,24,2,40,0.34895156800890703
340,swap,12437.0,397,16,24,2,40,0.34895156800890703
341,swap,12437.0,397,16,24,2,40,0.34895156800890703
342,swap,12437.0,397,16,24,2,40,0.34895156800890703
343,swap,12436.0,396,16,24,2,40,0.3470834874830437
344,swap,12145.0,405,16,23,2,39,0.3538612856145694
345,swap,12145.0,405,16,23,2,39,0.3538612856145694
346,swap,12145.0,405,16,23,2,39,0.3538612856145694
347,swap,12145.0,405,16,23,2,39,0.3538612856145694
348,swap,12145.0,405,16,23,2,39,0.3538612856145694
349,swap,12145.0,405,16,23,2,39,0.3538612856145694
350,swap,12144.0,404,16,23,2,39,0.35199240986717273
351,swap,12144.0,404,16,23,2,39,0.35199240986717273
352,swap,12144.0,404,16,23,2,39,0.35199240986717273
353,swap,12144.0,404,16,23,2,39,0.35199240986717273
354,swap,12144.0,404,16,23,2,39,0.35199240986717273
355,swap,12144.0,404,16,23,2,39,0.35199240986717273
356,swap,12144.0,404,16,23,2,39,0.35199240986717273
357,swap,12144.0,404,16,23,2,39,0.35199240986717273
358,swap,12144.0,404,16,23,2,39,0.35199240986717273
359,swap,12144.0,404,16,23,2,39,0.35199240986717273
360,reassign,12144.0,404,16,23,2,39,0.35199240986717273
361,mut_micro,12144.0,404,16,23,2,39,0.35199240986717273
362,mut_micro,12144.0,404,16,23,2,39,0.35199240986717273
363,mut_micro,11848.0,408,15,23,2,38,0.3556965269768039
364,mut_micro,11848.0,408,15,23,2,38,0.3556965269768039
365,mut_micro,11848.0,408,15,23,2,38,0.3556965269768039
366,mut_micro,11848.0,408,15,23,2,38,0.3556965269768039
367,mut_micro,11848.0,408,15,23,2,38,0.3556965269768039
368,mut_micro,11848.0,408,15,23,2,38,0.3556965269768039
369,mut_micro,11848.0,408,15,23,2,38,0.3556965269768039
370,swap,11848.0,408,15,23,2,38,0.3556965269768039
371,swap,11848.0,408,15,23,2,38,0.3556965269768039
372,swap,11848.0,408,15,23,2,38,0.3556965269768039
373,swap,11848.0,408,15,23,2,38,0.3556965269768039
374,swap,11848.0,408,15,23,2,38,0.3556965269768039
375,swap,11848.0,408,15,23,2,38,0.3556965269768039
376,reassign,11848.0,408,15,23,2,38,0.3556965269768039
377,swap,11848.0,408,15,23,2,38,0.3556965269768039
378,reassign,11848.0,408,15,23,2,38,0.3556965269768039
379,mut_micro,11848.0,408,15,23,2,38,0.3556965269768039
380,swap,11848.0,408,15,23,2,38,0.3556965269768039
381,swap,11848.0,408,15,23,2,38,0.3556965269768039
382,mut_micro,11848.0,408,15,23,2,38,0.3556965269768039
383,swap,11848.0,408,15,23,2,38,0.3556965269768039
384,swap,11848.0,408,15,23,2,38,0.3556965269768039
385,swap,11848.0,408,15,23,2,38,0.3556965269768039
386,swap,11848.0,408,15,23,2,38,0.3556965269768039
387,swap,11848.0,408,15,23,2,38,0.3556965269768039
388,swap,11848.0,408,15,23,2,38,0.3556965269768039
389,swap,11848.0,408,15,23,2,38,0.3556965269768039
390,swap,11848.0,408,15,23,2,38,0.3556965269768039
391,mut_micro,11848.0,408,15,23,2,38,0.3556965269768039
392,swap,11848.0,408,15,23,2,38,0.3556965269768039
393,swap,11848.0,408,15,23,2,38,0.3556965269768039
394,mut_micro,11848.0,408,15,23,2,38,0.3556965269768039
395,swap,11848.0,408,15,23,2,38,0.3556965269768039
396,swap,11848.0,408,15,23,2,38,0.3556965269768039
397,swap,11848.0,408,15,23,2,38,0.3556965269768039
398,swap,11848.0,408,15,23,2,38,0.3556965269768039
399,swap,11848.0,408,15,23,2,38,0.3556965269768039
400,swap,11848.0,408,15,23,2,38,0.3556965269768039
401,swap,11848.0,408,15,23,2,38,0.3556965269768039
402,swap,11848.0,408,15,23,2,38,0.3556965269768039
403,swap,11846.0,406,15,23,2,38,0.356951871657754
404,swap,11846.0,406,15,23,2,38,0.356951871657754
405,swap,11846.0,406,15,23,2,38,0.356951871657754
406,swap,11846.0,406,15,23,2,38,0.356951871657754
407,swap,11846.0,406,15,23,2,38,0.356951871657754
408,swap,11548.0,408,15,22,2,37,0.357362552864283
409,swap,11548.0,408,15,22,2,37,0.357362552864283
410,swap,11548.0,408,15,22,2,37,0.357362552864283
411,swap,11548.0,408,15,22,2,37,0.357362552864283
412,swap,11548.0,408,15,22,2,37,0.357362552864283
413,swap,11548.0,408,15,22,2,37,0.357362552864283
414,swap,11548.0,408,15,22,2,37,0.357362552864283
415,swap,11548.0,408,15,22,2,37,0.357362552864283
416,swap,11548.0,408,15,22,2,37,0.357362552864283
417,mut_micro,11244.0,404,13,23,2,36,0.35654648956356744
418,swap,11244.0,404,13,23,2,36,0.35654648956356744
419,swap,11244.0,404,13,23,2,36,0.35654648956356744
420,swap,11244.0,404,13,23,2,36,0.35654648956356744
421,swap,11244.0,404,13,23,2,36,0.35654648956356744
422,swap,11244.0,404,13,23,2,36,0.35654648956356744
423,swap,11244.0,404,13,23,2,36,0.35654648956356744
424,swap,11244.0,404,13,23,2,36,0.35654648956356744
425,swap,11244.0,404,13,23,2,36,0.35654648956356744
426,swap,11244.0,404,13,23,2,36,0.35654648956356744
427,swap,11244.0,404,13,23,2,36,0.35654648956356744
428,swap,11244.0,404,13,23,2,36,0.35654648956356744
429,swap,11244.0,404,13,23,2,36,0.35654648956356744
430,swap,11244.0,404,13,23,2,36,0.35654648956356744
431,swap,11244.0,404,13,23,2,36,0.35654648956356744
432,swap,11244.0,404,13,23,2,36,0.35654648956356744
433,swap,11244.0,404,13,23,2,36,0.35654648956356744
434,swap,11244.0,404,13,23,2,36,0.35654648956356744
435,swap,11244.0,404,13,23,2,36,0.35654648956356744
436,swap,11244.0,404,13,23,2,36,0.35654648956356744
437,swap,11242.0,402,13,23,2,36,0.3548265460030166
438,swap,11242.0,402,13,23,2,36,0.3548265460030166
439,mut_micro,11242.0,402,13,23,2,36,0.3548265460030166
440,swap,11242.0,402,13,23,2,36,0.3548265460030166
441,swap,11242.0,402,13,23,2,36,0.3548265460030166
442,swap,11242.0,402,13,23,2,36,0.3548265460030166
443,swap,11242.0,402,13,23,2,36,0.3548265460030166
444,swap,11242.0,402,13,23,2,36,0.3548265460030166
445,swap,11242.0,402,13,23,2,36,0.3548265460030166
446,swap,11242.0,402,13,23,2,36,0.3548265460030166
447,swap,11242.0,402,13,23,2,36,0.3548265460030166
448,swap,11242.0,402,13,23,2,36,0.3548265460030166
449,swap,11242.0,402,13,23,2,36,0.3548265460030166
450,swap,11242.0,402,13,23,2,36,0.3548265460030166
451,swap,11242.0,402,13,23,2,36,0.3548265460030166
452,swap,11242.0,402,13,23,2,36,0.3548265460030166
453,swap,11242.0,402,13,23,2,36,0.3548265460030166
454,swap,11242.0,402,13,23,2,36,0.3548265460030166
455,swap,11242.0,402,13,23,2,36,0.3548265460030166
456,mut_micro,11241.0,401,13,23,2,36,0.35290985403746167
457,swap,11241.0,401,13,23,2,36,0.35290985403746167
458,swap,11241.0,401,13,23,2,36,0.35290985403746167
459,swap,11241.0,401,13,23,2,36,0.35290985403746167
460,swap,11241.0,401,13,23,2,36,0.35290985403746167
461,swap,11237.0,397,13,23,2,36,0.34901342240366184
462,swap,11237.0,397,13,23,2,36,0.34901342240366184
463,swap,11237.0,397,13,23,2,36,0.34901342240366184
464,swap,11237.0,397,13,23,2,36,0.34901342240366184
465,swap,11237.0,397,13,23,2,36,0.34901342240366184
466,swap,11237.0,397,13,23,2,36,0.34901342240366184
467,swap,11237.0,397,13,23,2,36,0.34901342240366184
468,swap,11237.0,397,13,23,2,36,0.34901342240366184
469,swap,11237.0,397,13,23,2,36,0.34901342240366184
470,swap,11237.0,397,13,23,2,36,0.34901342240366184
471,swap,11237.0,397,13,23,2,36,0.34901342240366184
472,swap,10942.0,402,13,22,2,35,0.35193564605329314
473,swap,10942.0,402,13,22,2,35,0.35193564605329314
474,swap,10942.0,402,13,22,2,35,0.35193564605329314
475,swap,10942.0,402,13,22,2,35,0.35193564605329314
476,swap,10942.0,402,13,22,2,35,0.35193564605329314
477,reassign,10942.0,402,13,22,2,35,0.35193564605329314
478,swap,10942.0,402,13,22,2,35,0.35193564605329314
479,swap,10942.0,402,13,22,2,35,0.35193564605329314
480,swap,10942.0,402,13,22,2,35,0.35193564605329314
481,swap,10942.0,402,13,22,2,35,0.35193564605329314
482,mut_micro,10942.0,402,13,22,2,35,0.35193564605329314
483,swap,10942.0,402,13,22,2,35,0.35193564605329314
484,swap,10942.0,402,13,22,2,35,0.35193564605329314
485,swap,10942.0,402,13,22,2,35,0.35193564605329314
486,swap,10942.0,402,13,22,2,35,0.35193564605329314
487,swap,10942.0,402,13,22,2,35,0.35193564605329314
488,swap,10942.0,402,13,22,2,35,0.35193564605329314
489,swap,10942.0,402,13,22,2,35,0.35193564605329314
490,swap,10640.0,400,13,21,2,34,0.35300362183089795
491,swap,10640.0,400,13,21,2,34,0.35300362183089795
492,swap,10640.0,400,13,21,2,34,0.35300362183089795
493,swap,10640.0,400,13,21,2,34,0.35300362183089795
494,swap,10640.0,400,13,21,2,34,0.35300362183089795
495,swap,10640.0,400,13,21,2,34,0.35300362183089795
496,swap,10640.0,400,13,21,2,34,0.35300362183089795
497,swap,10640.0,400,13,21,2,34,0.35300362183089795
498,swap,10640.0,400,13,21,2,34,0.35300362183089795
499,swap,10640.0,400,13,21,2,34,0.35300362183089795
500,swap,10640.0,400,13,21,2,34,0.35300362183089795
501,swap,10640.0,400,13,21,2,34,0.35300362183089795
502,swap,10640.0,400,13,21,2,34,0.35300362183089795
503,swap,10640.0,400,13,21,2,34,0.35300362183089795
504,swap,10640.0,400,13,21,2,34,0.35300362183089795
505,swap,10640.0,400,13,21,2,34,0.35300362183089795
506,swap,10640.0,400,13,21,2,34,0.35300362183089795
507,swap,10640.0,400,13,21,2,34,0.35300362183089795
508,swap,10640.0,400,13,21,2,34,0.35300362183089795
509,swap,10640.0,400,13,21,2,34,0.35300362183089795
510,swap,10640.0,400,13,21,2,34,0.35300362183089795
511,swap,10640.0,400,13,21,2,34,0.35300362183089795
512,swap,10640.0,400,13,21,2,34,0.35300362183089795
513,swap,10640.0,400,13,21,2,34,0.35300362183089795
514,swap,10640.0,400,13,21,2,34,0.35300362183089795
515,swap,10640.0,400,13,21,2,34,0.35300362183089795
516,swap,10640.0,400,13,21,2,34,0.35300362183089795
517,swap,10640.0,400,13,21,2,34,0.35300362183089795
518,swap,10640.0,400,13,21,2,34,0.35300362183089795
519,reassign,10640.0,400,13,21,2,34,0.35300362183089795
520,swap,10640.0,400,13,21,2,34,0.35300362183089795
521,swap,10640.0,400,13,21,2,34,0.35300362183089795
522,swap,10640.0,400,13,21,2,34,0.35300362183089795
523,swap,10640.0,400,13,21,2,34,0.35300362183089795
524,swap,10640.0,400,13,21,2,34,0.35300362183089795
525,swap,10640.0,400,13,21,2,34,0.35300362183089795
526,swap,10640.0,400,13,21,2,34,0.35300362183089795
527,swap,10640.0,400,13,21,2,34,0.35300362183089795
528,swap,10640.0,400,13,21,2,34,0.35300362183089795
529,swap,10640.0,400,13,21,2,34,0.35300362183089795
530,swap,10640.0,400,13,21,2,34,0.35300362183089795
531,swap,10640.0,400,13,21,2,34,0.35300362183089795
532,reassign,10640.0,400,13,21,2,34,0.35300362183089795
533,swap,10640.0,400,13,21,2,34,0.35300362183089795
534,swap,10640.0,400,13,21,2,34,0.35300362183089795
535,swap,10640.0,400,13,21,2,34,0.35300362183089795
536,swap,10640.0,400,13,21,2,34,0.35300362183089795
537,swap,10640.0,400,13,21,2,34,0.35300362183089795
538,swap,10640.0,400,13,21,2,34,0.35300362183089795
539,swap,10640.0,400,13,21,2,34,0.35300362183089795
540,swap,10640.0,400,13,21,2,34,0.35300362183089795
541,reassign,10640.0,400,13,21,2,34,0.35300362183089795
542,swap,10640.0,400,13,21,2,34,0.35300362183089795
543,swap,10640.0,400,13,21,2,34,0.35300362183089795
544,swap,10640.0,400,13,21,2,34,0.35300362183089795
545,swap,10640.0,400,13,21,2,34,0.35300362183089795
546,swap,10640.0,400,13,21,2,34,0.35300362183089795
547,swap,10640.0,400,13,21,2,34,0.35300362183089795
548,swap,10640.0,400,13,21,2,34,0.35300362183089795
549,swap,10640.0,400,13,21,2,34,0.35300362183089795
550,swap,10640.0,400,13,21,2,34,0.35300362183089795
551,swap,10640.0,400,13,21,2,34,0.35300362183089795
552,swap,10640.0,400,13,21,2,34,0.35300362183089795
553,swap,10640.0,400,13,21,2,34,0.35300362183089795
554,swap,10640.0,400,13,21,2,34,0.35300362183089795
555,swap,10640.0,400,13,21,2,34,0.35300362183089795
556,swap,10640.0,400,13,21,2,34,0.35300362183089795
557,swap,10640.0,400,13,21,2,34,0.35300362183089795
558,swap,10637.0,397,13,21,2,34,0.34901342240366184
559,swap,10637.0,397,13,21,2,34,0.34901342240366184
560,swap,10637.0,397,13,21,2,34,0.34901342240366184
561,swap,10637.0,397,13,21,2,34,0.34901342240366184
562,swap,10637.0,397,13,21,2,34,0.34901342240366184
563,swap,10637.0,397,13,21,2,34,0.34901342240366184
564,swap,10342.0,402,13,20,2,33,0.35193564605329314
565,swap,10342.0,402,13,20,2,33,0.35193564605329314
566,swap,10342.0,402,13,20,2,33,0.35193564605329314
567,swap,10052.0,412,13,19,2,32,0.3570964809764966
568,swap,10052.0,412,13,19,2,32,0.3570964809764966
569,swap,10052.0,412,13,19,2,32,0.3570964809764966
570,swap,10052.0,412,13,19,2,32,0.3570964809764966
571,swap,10052.0,412,13,19,2,32,0.3570964809764966
572,swap,10052.0,412,13,19,2,32,0.3570964809764966
573,swap,10052.0,412,13,19,2,32,0.3570964809764966
574,swap,10051.0,411,13,19,2,32,0.35730926033779853
575,swap,10051.0,411,13,19,2,32,0.35730926033779853
576,mut_micro,10051.0,411,13,19,2,32,0.35730926033779853
577,swap,10051.0,411,13,19,2,32,0.35730926033779853
578,swap,10051.0,411,13,19,2,32,0.35730926033779853
579,reassign,10051.0,411,13,19,2,32,0.35730926033779853
580,swap,9751.0,411,13,18,2,31,0.35730926033779853
581,swap,9751.0,411,13,18,2,31,0.35730926033779853
582,swap,9751.0,411,13,18,2,31,0.35730926033779853
583,swap,9751.0,411,13,18,2,31,0.35730926033779853
584,swap,9751.0,411,13,18,2,31,0.35730926033779853
585,swap,9751.0,411,13,18,2,31,0.35730926033779853
586,swap,9751.0,411,13,18,2,31,0.35730926033779853
587,swap,9751.0,411,13,18,2,31,0.35730926033779853
588,swap,9751.0,411,13,18,2,31,0.35730926033779853
589,swap,9751.0,411,13,18,2,31,0.35730926033779853
590,swap,9751.0,411,13,18,2,31,0.35730926033779853
591,swap,9751.0,411,13,18,2,31,0.35730926033779853
592,swap,9751.0,411,13,18,2,31,0.35730926033779853
593,swap,9751.0,411,13,18,2,31,0.35730926033779853
594,swap,9751.0,411,13,18,2,31,0.35730926033779853
595,swap,9751.0,411,13,18,2,31,0.35730926033779853
596,swap,9749.0,409,13,18,2,31,0.3554162648666024
597,reassign,9749.0,409,13,18,2,31,0.3554162648666024
598,mut_micro,9746.0,406,13,18,2,31,0.3515406162464985
599,swap,9744.0,404,13,18,2,31,0.35104364326375714
600,swap,9744.0,404,13,18,2,31,0.35104364326375714
601,swap,9744.0,404,13,18,2,31,0.35104364326375714
602,swap,9744.0,404,13,18,2,31,0.35104364326375714
603,mut_micro,9744.0,404,13,18,2,31,0.35104364326375714
604,swap,9744.0,404,13,18,2,31,0.35104364326375714
605,swap,9744.0,404,13,18,2,31,0.35104364326375714
606,swap,9744.0,404,13,18,2,31,0.35104364326375714
607,swap,9744.0,404,13,18,2,31,0.35104364326375714
608,swap,9744.0,404,13,18,2,31,0.35104364326375714
609,swap,9744.0,404,13,18,2,31,0.35104364326375714
610,swap,9744.0,404,13,18,2,31,0.35104364326375714
611,swap,9744.0,404,13,18,2,31,0.35104364326375714
612,swap,9744.0,404,13,18,2,31,0.35104364326375714
613,swap,9744.0,404,13,18,2,31,0.35104364326375714
614,swap,9744.0,404,13,18,2,31,0.35104364326375714
615,swap,9744.0,404,13,18,2,31,0.35104364326375714
616,swap,9744.0,404,13,18,2,31,0.35104364326375714
617,swap,9744.0,404,13,18,2,31,0.35104364326375714
618,swap,9744.0,404,13,18,2,31,0.35104364326375714
619,swap,9744.0,404,13,18,2,31,0.35104364326375714
620,reassign,9744.0,404,13,18,2,31,0.35104364326375714
621,swap,9744.0,404,13,18,2,31,0.35104364326375714
622,swap,9744.0,404,13,18,2,31,0.35104364326375714
623,swap,9744.0,404,13,18,2,31,0.35104364326375714
624,swap,9744.0,404,13,18,2,31,0.35104364326375714
625,swap,9744.0,404,13,18,2,31,0.35104364326375714
626,swap,9743.0,403,13,18,2,31,0.35215307988147027
627,swap,9743.0,403,13,18,2,31,0.35215307988147027
628,reassign,9442.0,402,13,17,2,30,0.3531925590749121
629,swap,9442.0,402,13,17,2,30,0.3531925590749121
630,swap,9442.0,402,13,17,2,30,0.3531925590749121
631,swap,9442.0,402,13,17,2,30,0.3531925590749121
632,swap,9441.0,401,13,17,2,30,0.35128108751487813
633,swap,9441.0,401,13,17,2,30,0.35128108751487813
634,swap,9441.0,401,13,17,2,30,0.35128108751487813
635,swap,9441.0,401,13,17,2,30,0.35128108751487813
636,swap,9441.0,401,13,17,2,30,0.35128108751487813
637,swap,9441.0,401,13,17,2,30,0.35128108751487813
638,swap,9441.0,401,13,17,2,30,0.35128108751487813
639,swap,9441.0,401,13,17,2,30,0.35128108751487813
640,swap,9441.0,401,13,17,2,30,0.35128108751487813
641,swap,9441.0,401,13,17,2,30,0.35128108751487813
642,mut_micro,9441.0,401,13,17,2,30,0.35128108751487813
643,swap,9441.0,401,13,17,2,30,0.35128108751487813
644,swap,9441.0,401,13,17,2,30,0.35128108751487813
645,swap,9441.0,401,13,17,2,30,0.35128108751487813
646,swap,9441.0,401,13,17,2,30,0.35128108751487813
647,swap,9441.0,401,13,17,2,30,0.35128108751487813
648,swap,9441.0,401,13,17,2,30,0.35128108751487813
649,reassign,9436.0,396,12,18,2,30,0.348316685164632
650,swap,9436.0,396,12,18,2,30,0.348316685164632
651,swap,9436.0,396,12,18,2,30,0.348316685164632
652,swap,9436.0,396,12,18,2,30,0.348316685164632
653,reassign,9436.0,396,12,18,2,30,0.348316685164632
654,swap,9434.0,394,12,18,2,30,0.34761029411764705
655,swap,9434.0,394,12,18,2,30,0.34761029411764705
656,swap,9434.0,394,12,18,2,30,0.34761029411764705
657,swap,9430.0,390,12,18,2,30,0.34343984507383196
658,swap,9430.0,390,12,18,2,30,0.34343984507383196
659,swap,9430.0,390,12,18,2,30,0.34343984507383196
660,swap,9430.0,390,12,18,2,30,0.34343984507383196
661,swap,9430.0,390,12,18,2,30,0.34343984507383196
662,swap,9430.0,390,12,18,2,30,0.34343984507383196
663,swap,9430.0,390,12,18,2,30,0.34343984507383196
664,swap,9138.0,398,12,17,2,29,0.35070737155621745
665,swap,9138.0,398,12,17,2,29,0.35070737155621745
666,swap,9138.0,398,12,17,2,29,0.35070737155621745
667,swap,9138.0,398,12,17,2,29,0.35070737155621745
668,swap,9138.0,398,12,17,2,29,0.35070737155621745
669,swap,9138.0,398,12,17,2,29,0.35070737155621745
670,swap,9138.0,398,12,17,2,29,0.35070737155621745
671,swap,9133.0,393,12,17,2,29,0.3446643454889745
672,swap,9133.0,393,12,17,2,29,0.3446643454889745
673,swap,9133.0,393,12,17,2,29,0.3446643454889745
674,swap,9133.0,393,12,17,2,29,0.3446643454889745
675,swap,9133.0,393,12,17,2,29,0.3446643454889745
676,swap,9133.0,393,12,17,2,29,0.3446643454889745
677,swap,9133.0,393,12,17,2,29,0.3446643454889745
678,swap,9133.0,393,12,17,2,29,0.3446643454889745
679,swap,9133.0,393,12,17,2,29,0.3446643454889745
680,swap,9133.0,393,12,17,2,29,0.3446643454889745
681,swap,9133.0,393,12,17,2,29,0.3446643454889745
682,swap,9133.0,393,12,17,2,29,0.3446643454889745
683,swap,9133.0,393,12,17,2,29,0.3446643454889745
684,swap,9133.0,393,12,17,2,29,0.3446643454889745
685,mut_micro,9131.0,391,12,17,2,29,0.34125538760395796
686,swap,9131.0,391,12,17,2,29,0.34125538760395796
687,swap,9131.0,391,12,17,2,29,0.34125538760395796
688,swap,9131.0,391,12,17,2,29,0.34125538760395796
689,swap,9131.0,391,12,17,2,29,0.34125538760395796
690,swap,9131.0,391,12,17,2,29,0.34125538760395796
691,swap,9131.0,391,12,17,2,29,0.34125538760395796
692,swap,9131.0,391,12,17,2,29,0.34125538760395796
693,swap,9131.0,391,12,17,2,29,0.34125538760395796
694,swap,9131.0,391,12,17,2,29,0.34125538760395796
695,reassign,9131.0,391,12,17,2,29,0.34125538760395796
696,swap,9131.0,391,12,17,2,29,0.34125538760395796
697,swap,9131.0,391,12,17,2,29,0.34125538760395796
698,swap,9131.0,391,12,17,2,29,0.34125538760395796
699,swap,9131.0,391,12,17,2,29,0.34125538760395796
700,mut_micro,9127.0,387,12,17,2,29,0.33696108412784076
701,swap,9127.0,387,12,17,2,29,0.33696108412784076
702,swap,9127.0,387,12,17,2,29,0.33696108412784076
703,swap,9127.0,387,12,17,2,29,0.33696108412784076
704,swap,9127.0,387,12,17,2,29,0.33696108412784076
705,swap,9127.0,387,12,17,2,29,0.33696108412784076
706,swap,9127.0,387,12,17,2,29,0.33696108412784076
707,swap,9125.0,385,12,17,2,29,0.3390249716908039
708,swap,9125.0,385,12,17,2,29,0.3390249716908039
709,swap,9123.0,383,12,17,2,29,0.3397606776849713
710,reassign,9123.0,383,12,17,2,29,0.3397606776849713
711,swap,9123.0,383,12,17,2,29,0.3397606776849713
712,swap,8827.0,387,12,16,2,28,0.34415662289380594
713,swap,8827.0,387,12,16,2,28,0.34415662289380594
714,swap,8827.0,387,12,16,2,28,0.34415662289380594
715,swap,8827.0,387,12,16,2,28,0.34415662289380594
716,swap,8827.0,387,12,16,2,28,0.34415662289380594
717,swap,8827.0,387,12,16,2,28,0.34415662289380594
718,swap,8827.0,387,12,16,2,28,0.34415662289380594
719,swap,8827.0,387,12,16,2,28,0.34415662289380594
720,swap,8827.0,387,12,16,2,28,0.34415662289380594
721,swap,8827.0,387,12,16,2,28,0.34415662289380594
722,swap,8827.0,387,12,16,2,28,0.34415662289380594
723,swap,8827.0,387,12,16,2,28,0.34415662289380594
724,swap,8827.0,387,12,16,2,28,0.34415662289380594
725,swap,8827.0,387,12,16,2,28,0.34415662289380594
726,swap,8827.0,387,12,16,2,28,0.34415662289380594
727,swap,8827.0,387,12,16,2,28,0.34415662289380594
728,swap,8827.0,387,12,16,2,28,0.34415662289380594
729,reassign,8827.0,387,12,16,2,28,0.34415662289380594
730,swap,8827.0,387,12,16,2,28,0.34415662289380594
731,swap,8827.0,387,12,16,2,28,0.34415662289380594
732,swap,8827.0,387,12,16,2,28,0.34415662289380594
733,mut_micro,8225.0,385,10,16,2,26,0.34075332260563795
734,swap,8225.0,385,10,16,2,26,0.34075332260563795
735,swap,8225.0,385,10,16,2,26,0.34075332260563795
736,mut_micro,8225.0,385,10,16,2,26,0.34075332260563795
737,reassign,8225.0,385,10,16,2,26,0.34075332260563795
738,mut_micro,8224.0,384,10,16,2,26,0.34159239453357104
739,mut_micro,8206.0,386,10,16,1,26,0.342479674796748
740,mut_micro,8206.0,386,10,16,1,26,0.342479674796748
741,swap,8206.0,386,10,16,1,26,0.342479674796748
742,swap,8206.0,386,10,16,1,26,0.342479674796748
743,swap,8206.0,386,10,16,1,26,0.342479674796748
744,swap,8206.0,386,10,16,1,26,0.342479674796748
745,swap,8206.0,386,10,16,1,26,0.342479674796748
746,swap,8206.0,386,10,16,1,26,0.342479674796748
747,mut_micro,8206.0,386,10,16,1,26,0.342479674796748
748,swap,8206.0,386,10,16,1,26,0.342479674796748
749,swap,8206.0,386,10,16,1,26,0.342479674796748
750,mut_micro,8206.0,386,10,16,1,26,0.342479674796748
751,swap,8206.0,386,10,16,1,26,0.342479674796748
752,swap,8206.0,386,10,16,1,26,0.342479674796748
753,swap,8206.0,386,10,16,1,26,0.342479674796748
754,mut_micro,8206.0,386,10,16,1,26,0.342479674796748
755,mut_micro,8206.0,386,10,16,1,26,0.342479674796748
756,reassign,8206.0,386,10,16,1,26,0.342479674796748
757,reassign,7909.0,389,10,15,1,25,0.34470588235294114
758,swap,7909.0,389,10,15,1,25,0.34470588235294114
759,reassign,7909.0,389,10,15,1,25,0.34470588235294114
760,mut_micro,7909.0,389,10,15,1,25,0.34470588235294114
761,mut_micro,7909.0,389,10,15,1,25,0.34470588235294114
762,swap,7909.0,389,10,15,1,25,0.34470588235294114
763,swap,7909.0,389,10,15,1,25,0.34470588235294114
764,swap,7909.0,389,10,15,1,25,0.34470588235294114
765,swap,7909.0,389,10,15,1,25,0.34470588235294114
766,swap,7909.0,389,10,15,1,25,0.34470588235294114
767,swap,7909.0,389,10,15,1,25,0.34470588235294114
768,swap,7909.0,389,10,15,1,25,0.34470588235294114
769,swap,7909.0,389,10,15,1,25,0.34470588235294114
770,swap,7909.0,389,10,15,1,25,0.34470588235294114
771,swap,7909.0,389,10,15,1,25,0.34470588235294114
772,swap,7909.0,389,10,15,1,25,0.34470588235294114
773,swap,7909.0,389,10,15,1,25,0.34470588235294114
774,swap,7909.0,389,10,15,1,25,0.34470588235294114
775,swap,7909.0,389,10,15,1,25,0.34470588235294114
776,swap,7909.0,389,10,15,1,25,0.34470588235294114
777,swap,7909.0,389,10,15,1,25,0.34470588235294114
778,swap,7906.0,386,10,15,1,25,0.3446915351506456
779,swap,7906.0,386,10,15,1,25,0.3446915351506456
780,swap,7906.0,386,10,15,1,25,0.3446915351506456
781,swap,7906.0,386,10,15,1,25,0.3446915351506456
782,swap,7906.0,386,10,15,1,25,0.3446915351506456
783,swap,7906.0,386,10,15,1,25,0.3446915351506456
784,swap,7906.0,386,10,15,1,25,0.3446915351506456
785,swap,7906.0,386,10,15,1,25,0.3446915351506456
786,swap,7906.0,386,10,15,1,25,0.3446915351506456
787,swap,7906.0,386,10,15,1,25,0.3446915351506456
788,swap,7906.0,386,10,15,1,25,0.3446915351506456
789,swap,7906.0,386,10,15,1,25,0.3446915351506456
790,swap,7906.0,386,10,15,1,25,0.3446915351506456
791,swap,7906.0,386,10,15,1,25,0.3446915351506456
792,swap,7906.0,386,10,15,1,25,0.3446915351506456
793,swap,7906.0,386,10,15,1,25,0.3446915351506456
794,swap,7906.0,386,10,15,1,25,0.3446915351506456
795,swap,7906.0,386,10,15,1,25,0.3446915351506456
796,swap,7906.0,386,10,15,1,25,0.3446915351506456
797,swap,7906.0,386,10,15,1,25,0.3446915351506456
798,swap,7906.0,386,10,15,1,25,0.3446915351506456
799,mut_micro,7906.0,386,10,15,1,25,0.3446915351506456
800,swap,7906.0,386,10,15,1,25,0.3446915351506456
801,swap,7906.0,386,10,15,1,25,0.3446915351506456
802,swap,7906.0,386,10,15,1,25,0.3446915351506456
803,swap,7906.0,386,10,15,1,25,0.3446915351506456
804,swap,7906.0,386,10,15,1,25,0.3446915351506456
805,swap,7906.0,386,10,15,1,25,0.3446915351506456
806,swap,7906.0,386,10,15,1,25,0.3446915351506456
807,swap,7906.0,386,10,15,1,25,0.3446915351506456
808,swap,7905.0,385,10,15,1,25,0.3426604684426961
809,swap,7905.0,385,10,15,1,25,0.3426604684426961
810,swap,7905.0,385,10,15,1,25,0.3426604684426961
811,mut_micro,7905.0,385,10,15,1,25,0.3426604684426961
812,swap,7905.0,385,10,15,1,25,0.3426604684426961
813,swap,7905.0,385,10,15,1,25,0.3426604684426961
814,swap,7905.0,385,10,15,1,25,0.3426604684426961
815,swap,7905.0,385,10,15,1,25,0.3426604684426961
816,swap,7905.0,385,10,15,1,25,0.3426604684426961
817,swap,7905.0,385,10,15,1,25,0.3426604684426961
818,swap,7905.0,385,10,15,1,25,0.3426604684426961
819,swap,7905.0,385,10,15,1,25,0.3426604684426961
820,swap,7905.0,385,10,15,1,25,0.3426604684426961
821,swap,7613.0,393,10,14,1,24,0.35095595870747065
822,swap,7613.0,393,10,14,1,24,0.35095595870747065
823,swap,7613.0,393,10,14,1,24,0.35095595870747065
824,swap,7613.0,393,10,14,1,24,0.35095595870747065
825,mut_micro,7613.0,393,10,14,1,24,0.35095595870747065
826,swap,7613.0,393,10,14,1,24,0.35095595870747065
827,swap,7613.0,393,10,14,1,24,0.35095595870747065
828,swap,7613.0,393,10,14,1,24,0.35095595870747065
829,swap,7613.0,393,10,14,1,24,0.35095595870747065
830,swap,7613.0,393,10,14,1,24,0.35095595870747065
831,swap,7613.0,393,10,14,1,24,0.35095595870747065
832,swap,7613.0,393,10,14,1,24,0.35095595870747065
833,swap,7613.0,393,10,14,1,24,0.35095595870747065
834,swap,7613.0,393,10,14,1,24,0.35095595870747065
835,swap,7613.0,393,10,14,1,24,0.35095595870747065
836,swap,7613.0,393,10,14,1,24,0.35095595870747065
837,swap,7613.0,393,10,14,1,24,0.35095595870747065
838,swap,7613.0,393,10,14,1,24,0.35095595870747065
839,swap,7613.0,393,10,14,1,24,0.35095595870747065
840,swap,7613.0,393,10,14,1,24,0.35095595870747065
841,swap,7613.0,393,10,14,1,24,0.35095595870747065
842,swap,7613.0,393,10,14,1,24,0.35095595870747065
843,swap,7613.0,393,10,14,1,24,0.35095595870747065
844,swap,7613.0,393,10,14,1,24,0.35095595870747065
845,swap,7613.0,393,10,14,1,24,0.35095595870747065
846,swap,7609.0,389,10,14,1,24,0.34687782805429856
847,swap,7609.0,389,10,14,1,24,0.34687782805429856
848,swap,7609.0,389,10,14,1,24,0.34687782805429856
849,swap,7609.0,389,10,14,1,24,0.34687782805429856
850,swap,7609.0,389,10,14,1,24,0.34687782805429856
851,swap,7609.0,389,10,14,1,24,0.34687782805429856
852,swap,7609.0,389,10,14,1,24,0.34687782805429856
853,swap,7609.0,389,10,14,1,24,0.34687782805429856
854,swap,7609.0,389,10,14,1,24,0.34687782805429856
855,mut_micro,7609.0,389,10,14,1,24,0.34687782805429856
856,swap,7609.0,389,10,14,1,24,0.34687782805429856
857,swap,7609.0,389,10,14,1,24,0.34687782805429856
858,swap,7609.0,389,10,14,1,24,0.34687782805429856
859,swap,7609.0,389,10,14,1,24,0.34687782805429856
860,swap,7609.0,389,10,14,1,24,0.34687782805429856
861,swap,7609.0,389,10,14,1,24,0.34687782805429856
862,swap,7609.0,389,10,14,1,24,0.34687782805429856
863,swap,7609.0,389,10,14,1,24,0.34687782805429856
864,swap,7606.0,386,10,14,1,24,0.3427187948350071
865,swap,7606.0,386,10,14,1,24,0.3427187948350071
866,swap,7606.0,386,10,14,1,24,0.3427187948350071
867,swap,7606.0,386,10,14,1,24,0.3427187948350071
868,swap,7606.0,386,10,14,1,24,0.3427187948350071
869,swap,7606.0,386,10,14,1,24,0.3427187948350071
870,swap,7606.0,386,10,14,1,24,0.3427187948350071
871,swap,7606.0,386,10,14,1,24,0.3427187948350071
872,swap,7606.0,386,10,14,1,24,0.3427187948350071
873,swap,7606.0,386,10,14,1,24,0.3427187948350071
874,swap,7606.0,386,10,14,1,24,0.3427187948350071
875,swap,7606.0,386,10,14,1,24,0.3427187948350071
876,swap,7606.0,386,10,14,1,24,0.3427187948350071
877,swap,7606.0,386,10,14,1,24,0.3427187948350071
878,swap,7606.0,386,10,14,1,24,0.3427187948350071
879,swap,7606.0,386,10,14,1,24,0.3427187948350071
880,swap,7606.0,386,10,14,1,24,0.3427187948350071
881,swap,7606.0,386,10,14,1,24,0.3427187948350071
882,swap,7306.0,386,10,13,1,23,0.3427187948350071
883,swap,7306.0,386,10,13,1,23,0.3427187948350071
884,swap,7306.0,386,10,13,1,23,0.3427187948350071
885,swap,7301.0,381,10,13,1,23,0.33913325089795665
886,swap,7301.0,381,10,13,1,23,0.33913325089795665
887,swap,7301.0,381,10,13,1,23,0.33913325089795665
888,swap,7301.0,381,10,13,1,23,0.33913325089795665
889,swap,7301.0,381,10,13,1,23,0.33913325089795665
890,swap,7301.0,381,10,13,1,23,0.33913325089795665
891,swap,7301.0,381,10,13,1,23,0.33913325089795665
892,swap,7301.0,381,10,13,1,23,0.33913325089795665
893,swap,7301.0,381,10,13,1,23,0.33913325089795665
894,swap,7301.0,381,10,13,1,23,0.33913325089795665
895,swap,7301.0,381,10,13,1,23,0.33913325089795665
896,swap,7301.0,381,10,13,1,23,0.33913325089795665
897,reassign,7301.0,381,10,13,1,23,0.33913325089795665
898,swap,7301.0,381,10,13,1,23,0.33913325089795665
899,swap,7301.0,381,10,13,1,23,0.33913325089795665
900,swap,7301.0,381,10,13,1,23,0.33913325089795665
901,swap,7301.0,381,10,13,1,23,0.33913325089795665
902,mut_micro,7301.0,381,10,13,1,23,0.33913325089795665
903,swap,7301.0,381,10,13,1,23,0.33913325089795665
904,swap,7301.0,381,10,13,1,23,0.33913325089795665
905,swap,7301.0,381,10,13,1,23,0.33913325089795665
906,swap,7301.0,381,10,13,1,23,0.33913325089795665
907,swap,7301.0,381,10,13,1,23,0.33913325089795665
908,swap,7301.0,381,10,13,1,23,0.33913325089795665
909,swap,7301.0,381,10,13,1,23,0.33913325089795665
910,swap,7301.0,381,10,13,1,23,0.33913325089795665
911,mut_micro,7301.0,381,10,13,1,23,0.33913325089795665
912,swap,7301.0,381,10,13,1,23,0.33913325089795665
913,swap,7301.0,381,10,13,1,23,0.33913325089795665
914,swap,7301.0,381,10,13,1,23,0.33913325089795665
915,swap,7301.0,381,10,13,1,23,0.33913325089795665
916,swap,7301.0,381,10,13,1,23,0.33913325089795665
917,swap,7301.0,381,10,13,1,23,0.33913325089795665
918,swap,7301.0,381,10,13,1,23,0.33913325089795665
919,swap,7301.0,381,10,13,1,23,0.33913325089795665
920,swap,7301.0,381,10,13,1,23,0.33913325089795665
921,swap,7301.0,381,10,13,1,23,0.33913325089795665
922,mut_micro,7301.0,381,10,13,1,23,0.33913325089795665
923,swap,7301.0,381,10,13,1,23,0.33913325089795665
924,swap,7301.0,381,10,13,1,23,0.33913325089795665
925,swap,7009.0,389,10,12,1,22,0.34482654600301665
926,swap,7009.0,389,10,12,1,22,0.34482654600301665
927,swap,7009.0,389,10,12,1,22,0.34482654600301665
928,swap,7009.0,389,10,12,1,22,0.34482654600301665
929,swap,7009.0,389,10,12,1,22,0.34482654600301665
930,swap,7008.0,388,10,12,1,22,0.3448213641284735
931,swap,7008.0,388,10,12,1,22,0.3448213641284735
932,reassign,7008.0,388,10,12,1,22,0.3448213641284735
933,swap,7008.0,388,10,12,1,22,0.3448213641284735
934,swap,7008.0,388,10,12,1,22,0.3448213641284735
935,swap,7008.0,388,10,12,1,22,0.3448213641284735
936,reassign,7008.0,388,10,12,1,22,0.3448213641284735
937,swap,7008.0,388,10,12,1,22,0.3448213641284735
938,swap,7008.0,388,10,12,1,22,0.3448213641284735
939,swap,7008.0,388,10,12,1,22,0.3448213641284735
940,swap,7008.0,388,10,12,1,22,0.3448213641284735
941,swap,7008.0,388,10,12,1,22,0.3448213641284735
942,mut_micro,7008.0,388,10,12,1,22,0.3448213641284735
943,swap,7008.0,388,10,12,1,22,0.3448213641284735
944,swap,7008.0,388,10,12,1,22,0.3448213641284735
945,swap,7008.0,388,10,12,1,22,0.3448213641284735
946,swap,7008.0,388,10,12,1,22,0.3448213641284735
947,swap,7008.0,388,10,12,1,22,0.3448213641284735
948,swap,7008.0,388,10,12,1,22,0.3448213641284735
949,swap,7008.0,388,10,12,1,22,0.3448213641284735
950,swap,7008.0,388,10,12,1,22,0.3448213641284735
951,swap,7008.0,388,10,12,1,22,0.3448213641284735
952,swap,7008.0,388,10,12,1,22,0.3448213641284735
953,swap,7008.0,388,10,12,1,22,0.3448213641284735
954,swap,7008.0,388,10,12,1,22,0.3448213641284735
955,swap,7008.0,388,10,12,1,22,0.3448213641284735
956,swap,7008.0,388,10,12,1,22,0.3448213641284735
957,swap,7008.0,388,10,12,1,22,0.3448213641284735
958,swap,7008.0,388,10,12,1,22,0.3448213641284735
959,swap,7008.0,388,10,12,1,22,0.3448213641284735
960,swap,7008.0,388,10,12,1,22,0.3448213641284735
961,swap,7008.0,388,10,12,1,22,0.3448213641284735
962,swap,7008.0,388,10,12,1,22,0.3448213641284735
963,swap,7008.0,388,10,12,1,22,0.3448213641284735
964,swap,7008.0,388,10,12,1,22,0.3448213641284735
965,swap,7008.0,388,10,12,1,22,0.3448213641284735
966,swap,7008.0,388,10,12,1,22,0.3448213641284735
967,swap,7008.0,388,10,12,1,22,0.3448213641284735
968,swap,7008.0,388,10,12,1,22,0.3448213641284735
969,swap,7008.0,388,10,12,1,22,0.3448213641284735
970,swap,7008.0,388,10,12,1,22,0.3448213641284735
971,reassign,7008.0,388,10,12,1,22,0.3448213641284735
972,swap,7008.0,388,10,12,1,22,0.3448213641284735
973,swap,7008.0,388,10,12,1,22,0.3448213641284735
974,swap,7008.0,388,10,12,1,22,0.3448213641284735
975,swap,7008.0,388,10,12,1,22,0.3448213641284735
976,swap,7008.0,388,10,12,1,22,0.3448213641284735
977,swap,7008.0,388,10,12,1,22,0.3448213641284735
978,swap,7008.0,388,10,12,1,22,0.3448213641284735
979,swap,7008.0,388,10,12,1,22,0.3448213641284735
980,swap,7008.0,388,10,12,1,22,0.3448213641284735
981,swap,7008.0,388,10,12,1,22,0.3448213641284735
982,swap,7008.0,388,10,12,1,22,0.3448213641284735
983,mut_micro,7008.0,388,10,12,1,22,0.3448213641284735
984,swap,7008.0,388,10,12,1,22,0.3448213641284735
985,swap,7008.0,388,10,12,1,22,0.3448213641284735
986,swap,7008.0,388,10,12,1,22,0.3448213641284735
987,swap,7008.0,388,10,12,1,22,0.3448213641284735
988,swap,7008.0,388,10,12,1,22,0.3448213641284735
989,swap,7008.0,388,10,12,1,22,0.3448213641284735
990,swap,7008.0,388,10,12,1,22,0.3448213641284735
991,swap,7008.0,388,10,12,1,22,0.3448213641284735
992,swap,7008.0,388,10,12,1,22,0.3448213641284735
993,mut_micro,7008.0,388,10,12,1,22,0.3448213641284735
994,swap,7008.0,388,10,12,1,22,0.3448213641284735
995,swap,7008.0,388,10,12,1,22,0.3448213641284735
996,mut_micro,7008.0,388,10,12,1,22,0.3448213641284735
997,mut_micro,7008.0,388,10,12,1,22,0.3448213641284735
998,reassign,7008.0,388,10,12,1,22,0.3448213641284735
999,reassign,7008.0,388,10,12,1,22,0.3448213641284735
1000,swap,7008.0,388,10,12,1,22,0.3448213641284735
